87
15 17 60 57
46 38 1 37 6 43 9 3 26 42 23 23 15 14 3 3 4 11 41 1 38 23 3 48 1 26 49 1 25 31 10 18 45 23 16 1 29 31 11 1 25 42 1 1 40 48 49 1 1 1 38 1 1 10 10 1 42 23 29 1 6 42 30 40 33 3 41 6 9 1 50 8 1 12 3 6 41 44 50 29 28 1 4 20 21 9 4
7 43 45 45 46 30 5 1 1 39 4 1 15 25 8 19 22 44 1 15 41 1 1 11 43 1 39 32 23 39 30 46 11 1 1 50 30 33 25 19 1 49 1 47 1 31 3 8 39 46 40 1 5 45 23 36 4 3 29 1 7 38 27 10 26 49 25 11 48 1 1 28 1 40 50 6 2 1 27 39 42 37 1 20 40 7 44
1 10 35 10 42 1 32 7 34 1 49 1 11 1 12 5 36 1 1 46 9 29 1 14 27 32 28 43 1 1 27 25 41 30 25 29 3 39 13 19 30 1 16 23 1 20 41 21 18 25 47 12 2 4 1 1 1 39 9 38 1 12 3 19 2 19 46 6 46 1 1 36 9 1 35 35 9 9 1 50 24 18 44 39 7 7 22
38 20 1 19 15 36 21 22 29 1 49 15 1 20 16 11 18 33 1 46 38 10 1 50 1 43 37 15 39 1 14 38 8 5 1 11 33 35 1 27 9 33 39 15 1 46 37 1 1 18 1 33 1 15 1 48 1 31 21 26 1 45 1 11 39 37 30 17 41 29 50 1 1 20 17 8 22 33 38 25 13 48 1 1 30 21 44
1 38 24 1 49 31 45 1 24 32 25 1 30 43 1 10 34 10 18 1 1 1 7 32 33 3 22 40 44 35 11 44 47 23 18 23 50 49 10 3 15 45 38 39 2 7 14 22 19 9 35 39 40 19 18 26 38 7 1 33 8 20 30 2 12 20 9 40 35 28 19 43 47 3 1 1 5 19 4 1 9 21 2 31 24 1 27
42 28 16 39 31 33 18 49 19 42 1 1 17 14 27 39 45 1 4 45 1 50 4 47 29 23 17 39 27 1 38 11 44 27 1 43 1 9 13 5 1 36 41 1 1 1 3 22 4 16 44 1 19 38 15 30 9 44 1 1 25 29 1 25 4 44 50 45 41 17 44 1 11 48 17 1 37 1 35 7 24 43 16 16 1 30 29
34 23 1 18 11 27 10 35 44 35 34 1 41 2 7 6 8 2 19 1 33 17 8 36 11 48 33 30 16 22 41 35 22 24 13 11 39 1 44 9 42 35 30 30 35 39 41 3 20 1 3 47 9 45 35 20 49 41 3 34 50 38 6 1 43 15 41 49 1 42 6 26 10 42 1 43 1 1 49 18 23 25 14 20 36 11 30
28 48 36 40 29 47 49 50 1 31 1 11 41 45 15 11 1 38 1 12 47 5 1 28 1 25 45 19 12 26 33 11 1 1 1 20 27 9 1 35 1 1 25 33 42 2 1 13 35 24 1 41 39 1 13 40 42 45 6 11 6 8 19 21 14 26 36 10 46 45 1 22 49 1 27 37 15 31 9 4 42 27 40 41 3 44 38
1 4 5 1 21 34 3 32 17 24 50 43 44 16 5 36 44 25 39 39 1 1 32 31 34 1 28 45 3 29 1 12 46 27 21 4 1 10 1 26 20 1 30 28 46 9 2 1 1 50 29 43 17 47 1 14 1 6 10 19 49 23 1 49 27 1 50 16 1 37 12 20 11 16 1 15 31 19 26 1 45 35 18 32 1 10 1
18 36 1 1 18 1 46 38 38 47 50 35 7 36 1 19 47 50 44 38 35 4 44 1 20 46 16 11 31 20 3 32 29 28 33 21 34 14 1 19 33 40 1 1 1 43 42 36 23 1 1 4 10 5 1 19 1 3 11 27 40 47 1 26 28 1 2 4 1 43 49 32 1 25 5 42 10 12 4 33 1 43 1 38 47 7 15
41 21 1 1 35 20 20 1 13 21 42 28 40 29 1 2 7 27 48 35 21 15 1 1 25 1 1 26 15 31 1 35 1 10 29 45 1 39 1 1 24 29 4 40 5 46 19 1 10 21 1 49 16 1 2 1 43 15 37 43 31 5 13 34 38 4 32 17 34 42 14 20 2 50 39 15 1 14 1 24 40 41 50 7 35 46 44
26 33 28 35 1 31 5 12 1 16 1 45 1 1 19 29 31 29 16 21 1 42 25 32 25 11 44 44 8 31 1 1 36 1 2 1 1 38 1 1 6 50 1 27 28 45 41 24 13 12 50 35 15 19 1 38 39 1 48 1 48 9 46 19 1 41 21 9 12 1 27 42 27 48 1 1 1 1 21 28 29 14 1 30 2 15 7
2 1 36 28 10 33 43 1 9 1 46 14 47 3 40 6 1 34 1 1 24 1 2 47 11 41 1 1 1 36 41 16 1 23 24 20 41 46 17 36 19 27 3 38 23 18 28 44 1 1 25 43 2 7 43 35 27 23 38 24 49 33 1 15 25 39 4 8 13 28 37 19 24 2 8 10 1 1 23 6 44 1 32 19 10 42 1
4 7 1 47 6 1 1 3 18 33 1 39 1 15 44 35 1 10 13 8 46 23 1 35 6 22 29 22 23 18 24 7 1 49 1 38 34 49 2 1 43 45 14 1 21 29 27 28 32 1 36 38 46 19 6 10 10 49 1 50 8 40 18 1 48 26 34 30 1 44 15 15 16 1 1 31 8 22 48 41 3 18 48 38 6 41 1
7 6 50 25 12 49 16 41 33 36 40 16 25 5 14 44 1 30 11 2 1 10 1 45 3 2 34 1 1 1 37 12 38 46 1 1 1 1 31 23 8 45 1 18 1 1 41 14 22 17 23 44 9 6 44 37 28 6 46 16 45 18 16 1 22 7 1 48 1 1 41 36 1 41 18 29 13 21 47 23 1 5 1 24 1 2 32
32 31 1 20 1 10 16 35 3 25 10 41 31 17 30 1 38 22 1 1 17 1 2 25 21 16 1 32 31 11 1 3 32 1 47 1 18 1 50 33 7 1 11 7 5 14 33 23 1 21 34 25 42 36 43 19 25 49 46 8 21 34 27 43 19 23 15 39 42 1 1 1 39 30 13 37 39 1 25 47 50 1 1 40 36 24 19
3 1 31 24 23 25 11 27 1 41 3 29 33 48 21 36 44 27 1 23 25 27 27 36 36 2 1 20 35 23 14 46 33 1 13 27 19 22 24 34 36 29 1 36 11 1 49 19 33 14 1 15 2 46 1 14 39 8 3 48 10 23 1 36 1 8 30 12 15 46 44 40 10 23 1 30 28 1 31 13 1 36 42 5 40 30 32
20 36 28 18 1 1 42 3 20 1 16 1 31 40 1 39 16 15 23 6 1 20 1 38 1 39 27 15 12 40 28 34 32 42 21 1 25 1 41 14 43 31 9 38 1 1 13 48 42 13 1 25 30 3 23 40 15 39 1 13 14 34 1 10 5 6 8 21 29 13 37 25 38 22 30 45 48 1 44 18 1 36 26 42 39 29 27
38 3 18 41 1 4 42 32 1 2 31 1 25 1 27 23 49 30 1 28 1 1 26 26 9 11 47 8 37 9 9 2 8 1 24 1 50 2 1 1 1 11 46 35 33 43 42 29 13 1 3 1 50 4 16 25 2 46 11 35 37 10 32 16 19 45 11 8 45 19 48 22 7 3 12 12 1 17 1 17 1 3 33 1 44 34 42
1 50 22 1 45 27 41 6 1 1 2 1 1 1 35 7 9 29 48 17 18 11 46 8 1 44 1 16 31 7 35 47 43 32 16 21 29 1 39 1 14 29 1 29 15 24 1 33 1 11 1 2 15 23 24 1 39 1 17 24 12 5 15 1 6 15 1 47 48 1 1 19 12 9 33 9 6 24 8 22 29 39 36 1 44 9 1
1 49 34 33 1 36 24 1 42 4 21 2 1 32 1 34 3 1 39 1 37 48 1 32 41 1 38 19 1 18 2 22 25 13 27 45 16 1 1 25 43 30 1 12 23 8 28 13 18 31 1 6 1 1 1 9 13 1 33 4 15 1 1 18 9 41 41 1 26 1 1 15 15 37 37 1 1 26 1 16 1 49 27 1 50 1 36
21 49 9 20 15 8 39 14 18 1 33 14 39 1 18 1 2 1 26 1 1 1 40 39 9 32 3 1 37 42 1 48 19 19 20 2 40 4 20 1 12 6 37 1 1 41 35 9 33 43 2 14 38 45 21 17 41 43 44 6 33 27 32 11 1 32 47 45 1 34 33 40 26 3 6 43 17 1 12 42 20 46 1 1 1 44 35
35 5 1 36 1 17 19 50 14 42 24 15 1 28 15 38 7 34 1 43 21 34 15 50 2 40 48 39 23 4 48 42 46 42 22 17 23 1 41 23 45 14 38 44 42 17 20 38 14 47 1 50 29 24 12 17 46 22 34 1 5 47 45 34 34 29 35 1 4 33 12 31 1 7 22 1 48 25 37 1 39 4 9 36 1 30 50
14 35 17 20 29 31 1 43 39 21 33 9 44 1 17 6 13 3 25 25 16 12 50 11 1 42 1 11 3 20 21 8 25 29 19 19 20 17 1 26 21 1 6 1 9 23 1 19 3 6 25 39 44 13 41 9 1 31 6 31 34 1 7 1 38 1 26 2 1 1 1 34 1 1 1 1 38 9 30 3 1 1 47 38 33 20 40
37 47 12 9 1 5 34 48 15 12 18 43 49 9 10 22 31 1 4 39 31 42 38 3 2 7 21 16 35 25 32 1 16 18 6 1 32 1 1 1 1 13 15 42 10 29 34 47 6 1 26 1 1 10 18 30 12 33 33 34 23 27 4 1 44 36 8 23 1 1 1 21 1 43 4 1 29 13 1 1 17 1 47 7 12 14 18
7 42 2 31 1 32 20 3 9 31 34 1 49 1 5 1 10 1 25 36 1 40 40 13 33 48 14 1 41 8 1 29 1 44 50 47 47 22 39 45 30 34 13 22 1 7 1 45 11 38 28 25 38 25 40 16 1 41 20 20 1 12 6 3 49 1 44 18 6 17 1 16 36 5 43 29 1 48 48 47 6 31 39 1 21 37 17
16 1 36 31 15 40 1 33 1 25 27 29 39 1 46 1 45 19 25 5 32 1 50 23 1 33 1 36 3 31 29 1 1 14 1 18 36 1 30 43 18 20 24 46 12 37 19 30 32 22 16 1 1 43 29 27 1 19 7 1 15 2 18 1 32 48 26 8 1 1 4 41 29 1 45 1 9 25 43 16 16 1 1 13 35 1 17
13 17 21 18 1 21 28 42 18 1 1 12 27 38 30 15 43 16 44 35 32 3 21 22 28 26 1 26 24 20 34 43 3 43 19 26 27 42 32 1 25 1 9 3 16 1 10 15 1 21 7 25 8 47 1 50 21 33 32 23 1 39 31 48 27 23 18 30 1 21 2 11 40 16 29 28 9 12 47 12 31 1 1 22 3 17 45
10 33 1 1 1 40 24 33 1 1 9 6 46 1 11 22 47 37 26 1 8 1 26 30 1 1 8 22 40 1 17 19 32 26 25 8 42 2 20 27 40 2 1 2 22 1 32 20 45 40 26 39 1 38 22 49 21 1 45 1 39 1 27 23 44 31 43 30 48 40 30 11 36 28 26 14 43 1 30 15 1 24 1 45 23 44 1
7 38 1 17 25 14 1 6 3 37 16 1 41 1 19 14 1 14 12 26 42 20 1 2 39 42 37 1 29 1 49 17 33 25 1 7 1 27 18 49 2 1 33 31 26 1 11 13 27 10 32 34 29 16 5 30 26 20 1 38 1 19 30 14 27 1 34 48 37 32 32 1 5 43 1 25 39 39 1 35 1 29 1 21 45 29 11
18 27 2 1 18 13 30 23 12 41 1 13 18 5 30 26 19 4 10 44 50 1 13 1 22 48 37 44 27 1 5 44 2 1 17 1 36 30 1 50 1 21 45 23 50 30 44 1 45 1 49 1 29 1 1 14 33 29 3 33 24 3 35 1 41 1 30 32 1 39 31 35 47 47 1 22 1 26 1 1 6 4 32 23 1 39 1
8 1 3 18 1 37 12 49 9 40 1 10 4 43 1 36 6 1 35 24 33 1 38 44 43 1 1 8 1 18 15 37 1 5 48 26 50 25 9 28 47 14 19 21 1 7 1 32 20 6 26 1 43 27 1 46 1 1 1 28 32 34 21 28 1 40 42 18 12 21 17 8 1 35 1 2 16 1 7 1 18 1 13 40 1 11 48
11 1 48 44 41 36 1 50 38 1 33 1 8 24 5 1 29 28 37 30 41 1 49 1 20 35 22 6 7 1 35 6 4 5 1 49 1 23 1 1 43 20 1 31 48 13 10 8 49 30 1 1 1 14 41 1 1 47 2 1 35 1 1 49 10 8 42 8 11 26 24 23 46 43 17 9 1 1 1 48 49 13 26 9 1 1 2
41 37 10 6 31 34 1 20 45 1 50 7 37 32 22 22 1 1 1 27 21 36 1 32 26 50 18 45 35 50 35 25 33 40 18 16 5 17 1 38 50 35 39 1 35 29 1 1 22 2 1 34 10 1 1 1 33 9 1 42 28 42 35 21 1 33 1 1 2 5 1 20 4 49 1 33 1 14 7 1 2 36 12 27 28 1 49
7 39 14 45 1 1 42 1 18 12 3 23 50 16 5 28 40 1 45 1 1 1 23 26 25 50 1 46 48 30 1 20 23 45 1 6 1 13 15 1 1 50 27 1 1 8 21 47 31 14 1 1 38 8 4 42 1 22 14 29 7 31 1 1 21 23 24 9 33 6 14 1 3 1 40 1 30 29 5 34 7 25 28 1 21 34 24
9 12 36 25 1 41 11 50 39 1 29 1 1 5 27 1 13 13 7 30 10 25 1 37 6 42 1 19 1 6 14 17 36 46 1 26 34 1 26 46 12 27 9 15 1 33 17 34 4 26 35 25 13 25 24 46 34 20 36 18 27 13 48 49 21 22 1 10 6 48 49 2 38 33 41 27 33 1 29 4 1 17 10 20 1 4 27
40 14 32 32 4 31 8 19 24 1 32 14 5 1 16 24 29 12 1 1 7 10 23 26 10 10 1 1 7 33 20 34 4 1 1 38 37 14 12 37 37 1 11 1 18 46 33 1 34 12 1 12 1 1 1 1 35 47 16 1 20 1 34 1 27 11 22 46 28 1 50 43 1 13 13 44 37 48 44 6 18 44 33 48 1 1 25
11 28 48 1 1 50 23 17 44 9 31 32 48 48 5 22 1 44 34 1 6 41 1 1 9 20 29 1 1 3 36 6 5 1 1 1 1 1 1 1 4 45 34 19 48 37 28 46 13 1 28 50 33 50 41 36 1 9 41 1 1 26 26 12 25 29 33 31 1 2 22 17 1 26 19 20 1 41 20 1 1 32 10 6 44 35 10
15 7 1 15 1 16 37 14 44 15 1 1 14 41 1 27 18 1 3 16 25 1 7 25 27 19 11 36 45 12 25 30 1 25 6 35 15 21 17 37 32 14 1 29 9 30 22 23 1 1 23 34 5 19 46 18 6 39 1 1 11 1 4 36 1 1 29 16 45 38 1 23 6 22 19 23 45 34 38 30 32 44 29 35 1 10 32
43 6 32 37 45 15 12 15 47 1 1 30 46 1 1 1 21 37 24 47 6 35 1 10 22 19 28 25 1 42 20 10 1 5 36 47 40 44 26 44 31 26 27 28 33 3 2 1 1 10 1 27 1 14 1 33 12 41 44 43 20 14 30 8 43 1 3 38 11 48 4 11 1 43 1 1 43 23 27 1 24 1 43 17 41 9 38
50 4 1 44 41 37 48 32 32 12 33 46 42 47 47 41 41 27 26 1 1 30 17 49 1 11 14 48 35 1 28 1 50 39 11 30 1 5 24 32 10 35 1 46 41 17 3 38 37 47 1 42 1 15 22 34 33 9 38 5 23 35 39 1 1 34 2 38 5 50 10 24 43 1 1 17 10 29 28 29 4 27 10 20 35 23 23
42 29 31 1 1 24 14 17 44 34 4 16 4 1 15 31 27 7 46 40 33 44 6 22 24 10 6 33 1 1 49 20 50 1 45 48 6 1 1 13 44 48 8 1 48 12 13 16 41 39 32 34 32 1 1 24 1 29 30 1 18 1 50 31 1 1 23 13 16 41 48 7 14 11 5 45 50 46 1 44 35 19 38 42 41 41 5
13 2 43 1 12 30 1 43 29 5 8 2 32 34 1 35 1 1 28 49 3 27 23 11 4 35 2 39 42 25 30 27 1 15 1 25 23 32 1 1 35 1 37 1 14 1 42 1 49 9 25 13 28 2 1 46 26 1 39 35 45 7 17 37 10 5 1 1 41 1 38 11 50 17 24 15 1 1 38 49 13 1 34 44 12 28 34
26 23 1 1 12 22 40 25 1 44 1 39 1 29 1 27 41 5 13 18 1 20 1 19 4 2 1 45 21 7 11 46 6 18 13 1 47 1 40 1 1 3 4 23 19 50 41 1 9 13 1 6 46 17 1 1 46 4 33 26 27 40 1 29 1 20 40 33 7 3 1 11 1 50 27 11 1 10 39 1 31 1 5 14 1 35 49
1 1 28 20 12 21 24 30 39 8 4 1 1 4 35 40 2 2 13 1 31 45 40 1 23 22 32 36 16 18 31 28 17 1 35 16 9 14 6 42 1 1 11 45 2 38 1 36 12 45 1 4 4 24 2 1 44 21 3 23 1 13 37 46 48 1 1 1 25 1 44 11 23 45 36 6 1 32 15 7 15 1 19 48 46 2 1
13 48 40 17 2 1 1 44 44 11 49 4 1 36 5 44 38 32 17 13 1 9 34 1 25 50 1 1 1 1 1 1 15 41 21 48 29 47 1 46 1 5 1 45 1 42 33 35 16 17 17 21 12 25 46 25 30 38 40 11 1 32 40 41 1 30 34 27 10 34 40 41 32 7 12 14 43 29 1 11 19 30 31 30 14 14 36
46 28 16 37 39 26 1 46 50 1 24 10 45 10 14 19 14 13 24 44 28 32 46 36 5 16 1 45 15 12 36 46 1 24 28 43 1 24 38 1 11 32 1 34 12 25 1 32 43 23 2 1 11 46 1 1 35 6 43 20 10 16 1 50 22 8 37 1 4 37 34 37 12 40 49 41 2 1 32 11 8 1 49 28 44 1 38
28 1 12 49 13 50 23 41 37 32 1 1 48 1 32 5 5 1 22 2 43 46 47 24 3 26 36 30 8 38 1 1 19 2 27 1 6 20 47 10 25 9 1 8 7 46 1 4 37 41 45 5 23 38 1 12 10 5 28 50 30 40 10 1 7 32 24 12 19 26 16 11 46 1 9 32 12 1 31 1 47 20 14 20 21 1 1
24 21 43 1 6 1 2 11 48 4 7 16 1 1 1 7 1 2 1 1 3 15 36 17 1 49 1 1 14 23 1 26 1 28 1 21 19 18 1 22 1 40 15 21 3 1 30 2 1 30 45 1 22 28 13 37 6 38 42 26 22 12 26 1 18 5 34 14 9 6 2 45 23 40 1 34 26 1 2 1 1 33 19 45 10 27 35
42 47 39 8 10 1 1 43 46 1 9 29 31 9 14 32 19 36 33 50 7 47 27 20 35 48 15 1 12 1 21 8 37 1 4 28 14 31 40 37 13 1 19 13 34 33 32 8 16 1 24 21 44 1 1 15 1 21 14 18 25 1 37 8 44 1 15 18 6 1 4 45 17 23 36 25 48 10 39 22 26 40 11 11 13 37 19
42 1 1 16 35 22 1 32 1 7 1 12 4 1 33 8 2 22 5 1 16 9 30 19 45 48 10 36 32 1 34 37 1 1 30 2 1 27 8 17 11 45 15 26 38 1 27 29 49 1 13 37 24 23 3 1 1 9 2 14 49 34 9 30 19 1 13 7 40 24 1 27 14 1 25 9 1 9 36 45 33 10 21 4 11 42 31
25 28 23 14 1 41 15 1 1 10 1 1 47 36 16 11 35 36 1 11 44 23 39 26 2 25 34 1 32 14 49 22 19 10 15 45 18 13 20 18 1 38 35 14 28 22 1 24 31 1 43 1 48 9 9 27 8 1 24 11 43 1 36 30 24 1 11 42 12 1 8 1 48 9 2 1 30 32 28 12 13 9 23 6 1 22 14
13 43 1 26 38 46 8 19 8 30 35 46 45 42 1 1 1 10 34 22 13 33 46 2 12 1 21 27 7 30 25 23 49 11 35 35 43 13 14 1 30 10 26 7 33 26 5 1 6 38 39 29 24 12 4 5 2 37 43 28 1 45 10 39 26 12 39 18 28 33 1 21 38 1 47 1 1 43 1 8 20 1 1 40 25 12 12
15 40 47 16 2 1 50 1 1 47 1 17 44 1 43 13 47 37 17 42 44 47 44 32 1 50 8 1 36 34 35 42 13 14 1 1 17 32 1 23 1 7 38 24 36 1 8 27 48 1 1 1 41 25 14 40 1 2 8 38 1 42 38 38 26 42 1 47 1 27 32 4 1 42 39 22 44 18 42 49 22 43 30 1 33 23 1
1 16 43 1 1 6 1 18 1 1 42 41 1 15 19 46 45 12 39 20 1 48 45 8 47 22 1 32 47 1 38 1 25 35 8 44 5 1 15 1 8 33 41 4 1 41 17 49 20 21 33 1 34 1 47 7 1 35 47 22 18 1 1 38 41 37 16 22 5 24 9 1 47 29 1 42 27 45 1 5 18 29 34 42 35 36 1
1 6 8 5 1 1 19 22 1 1 1 15 40 16 1 24 7 12 1 1 8 11 1 1 17 36 32 33 22 1 17 19 42 15 30 32 41 1 50 8 17 27 42 1 1 4 1 18 1 1 19 45 38 38 6 33 43 8 17 26 26 7 31 1 32 5 40 27 42 28 1 32 4 1 12 9 43 17 13 1 17 1 42 1 16 16 7
28 21 17 15 1 45 41 39 1 33 7 1 23 42 1 22 46 39 48 1 1 11 1 38 15 14 7 36 7 1 26 41 45 1 19 38 30 1 25 3 48 10 1 1 46 43 41 39 31 35 40 46 16 11 1 27 33 31 22 39 50 44 11 1 17 42 23 43 1 1 47 1 15 39 14 7 4 1 42 5 16 1 29 12 46 1 50
20 26 49 12 2 1 31 1 47 29 1 48 41 3 9 19 11 8 1 1 32 43 7 5 40 1 8 1 1 1 27 3 16 35 1 37 1 1 25 8 1 37 40 43 18 1 20 17 2 2 25 44 1 24 1 43 1 16 1 20 2 6 48 14 22 1 1 1 8 13 23 13 25 1 50 1 17 1 37 13 29 47 19 10 22 9 9
1 7 38 2 17 11 1 2 28 45 1 24 50 29 37 33 1 36 28 1 15 1 14 7 5 24 48 43 16 1 17 1 32 32 2 5 4 7 13 1 1 43 30 1 38 1 18 14 1 30 18 17 1 34 1 43 1 1 5 15 17 43 15 15 1 43 1 32 21 32 29 22 46 5 7 36 17 1 45 11 33 19 19 3 29 28 12
46 1 25 41 1 44 32 20 17 35 1 1 48 2 15 23 15 41 32 1 1 1 1 26 13 50 34 32 17 6 1 32 50 12 17 5 40 1 50 27 7 1 1 1 15 1 5 6 37 1 29 22 1 46 5 8 17 37 36 43 1 8 50 6 15 25 14 10 15 21 37 1 16 1 10 1 23 8 25 8 25 1 42 31 1 27 34
28 21 1 14 1 33 28 49 47 1 26 40 1 1 1 11 2 50 32 37 4 16 1 35 1 30 33 26 28 22 9 44 1 34 30 1 27 1 46 29 11 1 5 35 47 19 34 18 45 43 44 7 15 15 38 28 1 16 31 25 1 22 39 10 29 24 23 29 30 1 1 1 29 15 29 41 49 40 32 42 33 1 1 18 33 3 3
1 3 49 10 11 43 10 31 32 31 37 5 37 1 45 1 15 21 31 6 26 15 13 27 1 29 7 31 9 46 23 1 43 5 35 1 46 1 43 50 13 39 35 17 21 50 38 38 2 37 19 1 19 9 42 50 1 44 8 1 32 15 21 5 1 41 1 18 10 13 22 20 1 12 30 45 31 32 30 28 1 13 50 1 10 14 31
28 5 49 26 50 1 22 1 1 1 35 1 1 12 1 3 1 50 38 48 9 3 41 1 9 36 6 36 38 12 1 12 1 12 2 9 1 48 42 30 28 28 24 3 1 28 41 1 7 26 23 1 1 33 14 1 9 30 25 44 8 1 34 32 1 40 1 1 1 44 37 29 11 49 1 22 50 50 12 14 12 1 1 1 46 45 40
1 1 35 25 6 21 46 14 1 28 19 1 50 21 31 46 1 22 37 38 1 48 2 1 42 1 43 19 18 4 1 36 21 31 1 26 6 1 42 6 1 38 26 11 23 1 26 16 32 9 36 48 37 9 31 31 1 49 42 19 1 34 49 19 10 24 28 1 15 43 36 31 50 13 20 1 5 36 3 46 1 1 6 13 1 6 49
13 48 26 1 1 9 20 18 21 34 8 16 11 25 8 26 38 6 34 11 41 1 9 15 29 24 30 28 1 25 16 17 1 20 4 2 39 1 44 39 38 27 40 14 7 41 34 45 45 48 45 1 48 2 6 11 42 20 34 41 24 34 18 23 15 48 50 1 5 40 37 35 10 27 30 47 29 15 10 36 39 23 10 48 23 14 1
40 43 45 1 48 45 1 1 29 35 48 19 37 47 29 38 1 6 10 1 19 35 14 36 1 25 1 50 3 2 9 42 1 50 10 22 17 7 13 39 24 31 11 9 15 21 1 22 18 10 45 6 34 1 1 11 17 19 38 33 1 1 1 18 45 4 12 46 1 49 33 34 31 23 1 1 14 4 1 1 1 42 45 39 30 25 31
17 4 1 33 6 8 33 2 30 27 7 19 45 50 7 1 46 30 1 10 29 8 33 50 13 50 4 1 47 39 47 1 1 1 23 47 1 31 41 31 1 1 19 11 9 45 40 8 50 1 35 1 7 1 39 36 11 41 17 46 4 50 3 32 42 10 28 39 3 41 47 41 3 49 50 32 1 7 24 43 36 39 17 12 1 1 1
1 1 23 1 34 10 41 46 45 1 46 1 1 42 21 40 1 16 1 44 26 4 43 30 38 1 1 1 32 1 36 34 47 32 1 40 50 32 1 39 13 29 20 31 34 10 27 15 1 13 1 1 1 34 19 19 27 4 33 1 40 18 1 1 21 43 1 39 37 1 14 37 11 43 1 38 26 4 1 3 15 18 9 44 10 1 39
34 14 10 1 26 1 22 1 22 11 42 39 39 1 1 45 25 43 1 41 26 26 14 39 1 20 1 46 1 23 40 7 19 1 9 1 42 4 42 37 49 9 17 1 47 18 1 1 1 49 17 48 17 2 43 19 1 41 12 1 13 18 1 1 16 50 46 31 33 1 29 41 17 35 8 36 45 41 5 13 25 47 33 37 43 15 12
28 17 1 41 39 4 46 44 23 4 40 1 17 1 20 16 1 1 5 40 50 44 8 11 24 8 39 1 15 7 10 49 14 39 23 40 11 2 1 3 44 8 9 16 32 32 1 18 4 1 17 21 1 1 7 39 49 47 18 37 18 36 27 8 1 1 3 6 48 12 10 13 19 42 10 26 33 3 26 35 50 31 1 1 25 28 1
48 14 11 42 13 23 17 7 6 34 49 26 47 2 33 1 45 17 1 31 1 20 33 8 8 29 33 45 46 31 1 1 20 3 26 43 42 37 38 45 1 47 1 1 24 1 31 19 29 22 46 39 1 2 9 7 1 26 42 1 25 23 25 43 13 39 9 36 46 1 49 1 11 31 32 47 44 5 14 38 1 12 10 29 43 1 19
10 13 45 4 18 45 45 1 42 6 1 3 15 40 45 13 11 31 33 18 1 1 48 2 18 1 22 7 3 27 24 13 43 34 50 38 1 1 7 38 36 14 25 1 44 1 33 1 45 9 1 1 17 47 49 46 18 1 8 45 31 16 4 24 31 17 1 1 3 49 25 29 1 25 23 35 37 16 2 16 47 1 1 25 21 50 1
22 1 14 46 8 1 16 29 1 5 29 35 1 34 30 21 34 40 20 1 46 7 1 1 1 31 1 47 44 7 29 1 48 40 26 1 10 36 5 21 46 22 10 28 1 4 1 13 18 25 16 34 6 42 46 44 27 1 45 1 34 1 1 1 45 30 31 29 29 22 12 1 4 1 21 21 16 18 1 1 26 42 1 41 12 32 46
1 32 6 7 44 34 42 3 17 44 5 5 18 5 47 7 1 20 40 1 34 19 1 33 29 16 22 29 37 17 31 1 11 25 1 5 13 1 22 50 49 1 48 32 47 31 1 40 1 6 1 16 7 8 13 43 17 2 25 1 9 13 1 32 1 1 45 26 44 36 1 24 47 25 29 1 5 14 1 4 23 28 7 36 5 1 42
42 25 1 17 47 48 1 42 25 7 20 50 38 9 1 1 23 1 3 20 41 1 2 1 17 9 1 1 29 21 39 47 1 8 25 1 23 17 38 23 49 35 21 44 25 46 1 43 1 1 11 10 1 31 17 21 37 50 1 35 50 41 31 1 15 10 1 13 17 4 1 6 23 41 15 29 1 33 36 34 21 12 3 1 49 1 46
50 44 5 3 45 42 1 1 1 11 5 5 1 1 1 46 43 28 28 47 24 23 10 10 3 46 27 22 24 50 31 46 1 12 50 9 1 6 2 1 13 26 4 47 44 16 37 37 13 18 1 1 27 21 1 1 19 50 41 9 5 19 28 22 1 45 44 1 47 4 6 1 1 33 1 1 14 18 31 40 38 1 5 16 12 32 44
31 1 37 26 42 32 28 4 29 49 30 7 43 50 1 49 1 1 8 1 48 1 15 7 41 44 50 1 30 48 6 28 38 1 1 1 9 18 39 41 21 10 47 39 42 41 24 24 48 22 25 13 19 22 41 44 22 1 19 16 25 19 29 9 43 1 1 2 1 43 18 44 24 25 1 8 26 24 9 42 9 1 44 40 50 43 49
49 16 6 50 31 37 1 1 28 38 26 9 14 44 31 3 4 1 25 1 1 34 1 40 34 29 49 1 31 47 4 1 34 37 43 25 19 1 28 7 1 17 1 5 20 36 32 29 10 1 1 9 31 1 30 7 24 15 1 21 9 47 28 40 33 39 11 1 3 25 32 10 42 11 1 2 11 32 44 1 1 29 15 18 41 1 39
1 35 13 37 1 28 1 33 13 4 20 1 36 1 1 2 1 50 41 45 47 35 9 15 1 44 1 43 47 1 20 18 1 21 21 1 22 47 16 43 1 44 26 1 26 29 15 18 1 44 19 23 3 1 1 33 43 32 33 24 26 25 27 37 48 37 2 34 1 40 38 1 23 21 13 33 15 1 31 47 1 18 1 42 17 49 24
38 1 1 11 7 28 35 4 35 40 1 1 1 6 10 24 14 1 31 49 42 11 37 17 1 34 19 1 37 18 11 44 4 33 34 1 30 13 19 21 1 1 22 36 2 35 12 23 21 35 1 2 8 27 44 34 40 27 46 1 35 1 1 35 1 47 27 21 3 1 41 24 29 1 21 17 18 33 14 8 47 11 3 1 30 34 39
24 1 45 37 48 1 27 20 40 23 4 6 17 39 1 20 44 1 1 1 47 25 1 5 30 49 9 37 3 34 1 47 8 19 1 41 1 41 7 23 8 2 39 21 10 31 5 15 41 15 11 1 3 25 1 17 2 49 14 38 1 1 1 1 17 34 24 10 43 34 46 4 36 1 42 9 26 45 17 1 1 11 29 43 1 14 1
19 6 24 2 17 7 30 1 3 22 11 7 43 18 1 3 28 1 8 36 1 1 41 11 3 1 40 12 15 3 50 15 23 48 25 47 43 12 50 48 34 22 3 1 1 37 4 9 40 11 30 34 14 1 10 38 18 10 47 44 1 20 34 42 38 39 43 25 20 46 37 31 1 28 1 7 1 12 11 4 15 19 1 21 42 32 1
32 4 20 15 11 29 4 8 19 1 1 44 47 20 11 2 30 37 7 36 38 45 13 8 4 38 1 20 29 37 6 30 10 13 30 1 17 3 47 8 1 19 30 4 1 24 1 5 11 32 1 41 43 22 21 19 39 2 36 5 1 29 41 4 1 17 19 33 31 31 3 48 45 19 10 11 1 40 17 43 21 49 42 1 48 4 1
1 8 32 40 1 1 43 1 2 50 16 10 3 47 10 34 31 39 50 46 27 24 14 31 19 4 24 36 33 27 1 48 23 40 19 36 38 19 1 14 24 1 5 28 8 14 31 37 24 45 9 11 30 21 30 1 23 44 4 1 2 42 47 8 20 42 31 1 1 21 5 18 47 7 1 18 1 38 6 48 8 1 5 1 2 40 1
47 27 1 13 36 38 45 17 50 1 12 1 18 11 21 12 7 30 36 21 1 2 47 33 21 3 1 34 1 21 1 46 38 46 30 44 11 14 46 48 1 25 4 42 40 23 1 17 1 32 35 48 1 40 26 48 1 1 1 48 46 46 48 39 21 25 32 43 26 8 5 1 1 1 17 34 23 21 1 35 1 11 26 5 43 27 44
1 10 1 19 1 5 40 17 16 40 1 2 1 13 21 46 48 1 17 41 30 1 28 1 48 5 41 44 38 43 45 1 1 2 27 1 1 29 46 35 25 40 44 19 1 8 12 25 5 30 14 14 28 14 46 11 38 38 8 26 20 27 25 37 1 3 21 48 50 23 19 2 1 1 29 2 34 45 17 34 31 1 25 19 1 1 46
46 33 29 1 1 1 16 4 4 33 50 28 1 42 1 13 1 32 12 3 28 13 1 24 6 8 9 16 22 32 38 47 6 49 4 45 25 25 9 29 24 35 33 29 4 13 24 20 19 49 11 1 13 5 1 28 1 2 1 19 40 23 38 27 43 7 13 1 37 29 25 1 34 44 21 1 43 3 47 1 8 16 14 2 3 46 5
