82
24 17 58 54
1 47 1 26 42 12 20 1 1 12 10 42 37 33 7 1 1 30 27 1 1 19 36 48 28 50 14 6 26 12 9 8 1 45 24 1 36 24 41 35 1 1 10 1 5 48 10 15 15 49 36 1 15 25 31 14 1 26 46 1 23 24 5 44 1 7 24 22 8 41 49 1 5 16 43 24 1 19 36 1 6 36
17 10 26 48 27 42 1 23 12 49 8 25 38 13 37 38 43 47 8 1 1 30 33 39 31 15 1 34 44 38 1 13 8 1 40 1 1 9 25 28 32 1 1 1 42 13 15 1 36 7 23 30 37 19 6 34 5 14 1 3 21 44 28 41 25 29 44 1 1 19 39 36 1 29 14 14 6 11 35 11 1 43
5 1 8 30 7 18 7 20 15 39 1 25 12 2 10 13 43 5 23 33 46 15 20 48 1 46 1 7 3 46 1 25 27 23 2 46 1 1 1 1 31 30 1 25 27 1 4 1 35 38 7 40 38 48 43 41 32 37 29 15 41 9 5 33 14 49 14 17 4 1 17 32 19 3 1 18 23 17 22 25 10 1
44 10 1 1 32 46 6 1 37 39 9 16 12 12 20 43 16 24 1 37 24 1 39 3 44 13 21 7 25 11 41 5 35 28 15 22 43 18 27 49 1 46 14 10 45 22 33 14 1 1 21 36 4 14 3 6 1 16 2 30 1 19 37 11 1 1 48 28 1 1 15 17 22 1 43 43 1 1 47 8 10 1
17 40 2 21 13 29 26 3 28 1 10 1 37 21 19 24 34 1 16 1 1 3 40 46 7 26 48 1 22 1 1 22 9 45 11 21 32 1 29 12 1 1 25 50 16 6 32 1 26 11 27 9 1 30 47 37 15 21 16 2 37 28 1 37 28 7 11 36 12 32 47 1 1 1 1 6 1 34 26 11 23 30
13 1 1 29 28 6 11 46 35 48 21 25 35 1 42 10 49 1 1 49 3 7 17 30 1 29 30 1 8 15 40 7 1 37 22 1 9 42 14 37 9 35 36 1 10 1 1 48 12 1 1 19 50 1 49 26 24 23 34 43 1 38 9 48 27 36 34 3 1 6 40 28 38 41 46 19 15 26 10 26 12 6
2 41 8 13 16 1 48 35 50 32 29 13 1 1 35 27 1 18 1 11 18 49 38 45 35 22 28 24 1 23 1 47 44 1 1 35 1 23 1 41 19 19 10 1 18 37 40 40 39 33 38 49 12 17 1 1 1 32 23 40 34 49 1 8 4 4 32 23 14 1 34 1 20 24 4 7 32 15 2 1 1 19
1 10 40 31 1 12 26 1 18 39 21 20 22 45 46 44 50 32 20 40 17 32 43 15 1 1 50 5 30 15 40 46 46 22 32 35 43 25 1 19 11 50 33 1 28 17 50 38 36 46 9 1 5 45 22 50 9 37 39 19 20 1 29 15 1 1 31 12 36 1 42 7 6 10 1 29 29 1 1 30 7 40
8 22 28 8 14 41 13 15 7 26 1 9 44 6 13 17 35 27 7 18 3 33 18 25 1 1 1 48 38 1 1 21 1 20 31 5 15 47 2 1 1 32 26 32 13 23 29 26 1 47 7 1 2 18 34 22 10 15 8 1 29 29 26 1 46 8 4 1 47 18 20 1 6 1 38 50 25 1 2 41 1 21
1 37 1 1 41 1 35 1 1 17 49 26 46 1 42 39 1 31 9 26 17 10 21 31 1 1 16 1 22 12 1 1 12 22 1 25 31 12 36 4 1 1 3 46 40 33 1 46 13 1 13 14 48 1 37 40 50 1 44 2 38 15 40 14 5 49 22 1 34 49 38 30 49 5 5 1 3 5 21 1 22 1
34 26 5 30 39 1 1 30 1 1 16 1 12 1 40 31 23 26 1 48 1 1 15 1 37 23 24 18 29 17 36 20 28 5 2 1 10 27 40 34 34 48 11 50 34 10 3 11 49 48 9 37 18 40 1 22 2 13 39 9 1 18 37 9 21 11 40 17 16 15 37 35 1 37 37 20 1 17 3 1 14 1
48 37 6 39 38 19 1 10 6 16 11 1 34 19 50 34 4 45 32 1 12 1 37 50 23 30 1 1 32 1 5 10 25 20 44 15 19 13 42 4 41 1 1 24 1 1 24 1 48 17 3 47 1 8 9 24 12 46 10 15 47 48 46 40 1 23 16 1 25 7 36 9 1 37 40 4 5 1 50 28 17 2
45 1 1 8 17 13 23 47 1 7 50 24 18 19 14 1 10 33 1 30 15 26 1 41 1 1 1 23 1 37 42 1 31 34 10 47 7 12 23 13 35 1 32 26 1 1 11 25 28 2 1 30 12 28 26 32 1 9 30 35 50 44 49 23 17 36 5 32 13 7 1 1 5 12 41 22 21 37 25 44 1 48
12 13 24 24 32 1 8 43 32 8 33 39 19 1 14 10 1 46 11 41 1 40 2 28 19 6 42 8 1 28 2 32 42 25 12 43 11 39 42 1 16 1 33 19 3 1 33 1 13 22 1 6 35 17 1 12 3 44 2 10 40 9 19 1 41 1 21 1 2 4 50 30 28 1 1 30 30 43 1 21 10 42
31 1 31 2 48 45 7 42 39 46 1 22 36 37 34 47 13 15 33 27 9 24 1 23 41 34 7 1 34 9 24 36 11 13 43 4 22 8 1 1 47 15 1 42 40 1 8 1 1 11 29 1 1 7 37 37 1 28 36 33 35 39 5 1 1 29 49 8 20 26 5 14 15 22 26 3 37 1 33 23 10 37
21 29 37 37 4 16 10 14 1 44 44 9 21 1 1 22 50 9 5 48 14 30 46 1 31 2 8 37 13 40 11 1 12 1 9 11 50 19 5 28 50 49 49 1 47 35 1 13 1 48 3 39 26 14 18 19 41 24 1 1 31 22 12 1 30 48 33 1 26 1 44 19 15 16 38 11 50 20 15 43 1 1
3 39 3 1 1 44 6 24 26 36 20 24 38 13 18 14 49 28 19 1 13 1 1 16 22 1 1 49 18 22 21 15 1 38 14 34 1 25 7 28 1 46 20 10 35 25 36 3 16 10 7 28 1 1 1 38 44 48 33 1 20 16 1 18 28 17 1 12 27 40 37 25 28 1 41 1 40 12 8 18 1 29
3 31 1 38 1 34 24 2 27 50 1 50 1 1 8 41 21 21 42 24 9 27 34 42 4 1 46 28 3 22 3 26 15 6 13 19 50 40 1 37 33 20 30 26 48 1 1 44 13 14 7 39 8 31 6 10 5 1 1 15 1 1 1 48 1 41 34 26 27 25 1 50 13 1 1 37 1 2 35 49 14 24
40 50 48 20 8 1 1 50 48 12 3 48 17 1 48 29 21 15 32 1 50 6 1 1 1 9 13 1 35 34 12 1 18 1 21 1 22 9 1 16 45 26 35 1 1 39 46 42 35 42 31 1 1 31 31 8 47 1 9 35 21 13 38 33 1 47 20 30 39 16 1 35 24 1 38 19 15 1 31 11 23 40
13 27 24 35 3 8 26 42 16 36 25 1 23 1 8 1 42 9 4 14 1 17 7 36 34 12 49 1 32 1 3 2 39 1 32 7 8 50 1 6 31 39 26 29 17 5 1 41 47 8 27 38 4 35 47 29 29 1 3 17 3 4 24 1 1 1 1 43 1 17 32 15 1 48 2 1 11 34 13 19 1 2
1 12 40 36 21 37 1 36 50 31 36 42 26 20 20 15 14 45 1 46 1 34 3 1 1 46 17 25 29 1 40 1 24 6 8 4 25 1 10 49 1 2 41 33 44 12 6 47 36 24 43 40 1 9 1 4 42 16 20 36 42 48 1 43 7 26 32 49 4 12 9 3 1 9 38 34 1 40 2 31 1 29
21 42 43 41 47 50 3 1 31 11 11 34 26 8 36 1 1 4 35 26 25 50 39 39 23 7 27 37 49 24 15 14 1 33 33 1 48 10 1 18 48 1 8 50 1 17 1 5 24 1 3 40 33 40 2 45 1 25 47 10 40 1 1 47 43 31 46 42 33 45 5 23 12 41 1 1 49 3 38 1 18 26
20 18 30 2 1 1 44 13 41 28 37 16 1 5 49 1 1 29 34 26 16 1 1 1 13 42 21 1 45 1 37 28 26 9 17 20 44 1 38 5 33 1 3 1 33 17 45 1 7 39 1 8 33 13 28 8 1 24 38 1 36 18 1 35 31 50 47 16 25 1 1 36 4 31 33 15 16 23 7 21 1 2
47 28 15 50 39 22 25 47 47 42 5 15 38 1 1 34 1 7 11 43 17 5 36 1 6 26 1 15 23 33 1 21 39 1 41 1 25 17 30 1 18 11 24 30 17 3 13 14 1 1 33 7 18 1 35 42 1 4 21 47 31 15 11 44 1 23 25 1 1 1 26 1 10 2 38 1 40 33 49 1 3 1
1 15 38 10 19 37 22 1 21 11 47 13 9 50 16 32 22 3 33 26 26 18 39 1 1 22 1 24 1 10 46 1 1 38 1 42 17 13 22 7 35 25 50 21 40 35 19 1 1 16 32 21 37 45 1 1 1 1 38 1 7 11 23 28 1 15 11 21 22 20 29 45 45 27 3 1 32 31 40 6 48 1
13 1 38 18 4 30 1 13 1 14 31 19 17 45 10 21 11 23 6 24 11 36 25 1 35 12 1 6 43 1 34 31 5 49 21 30 1 1 1 9 15 12 30 14 10 1 12 45 23 22 1 12 1 20 44 29 27 5 44 40 1 41 11 1 1 49 20 29 12 47 11 5 50 36 34 37 12 29 1 1 6 1
6 36 40 1 1 1 1 7 2 4 1 50 43 1 1 42 1 1 1 2 27 40 18 41 1 20 23 50 1 21 42 10 1 34 50 1 6 1 48 2 45 26 30 17 45 11 42 24 33 1 40 19 3 24 47 45 29 25 1 15 38 49 21 1 43 33 6 28 37 44 47 1 1 1 1 25 1 24 41 1 15 2
2 24 1 33 16 45 38 19 31 10 1 42 42 1 21 42 4 1 1 49 1 18 23 4 16 45 11 19 20 4 17 31 4 28 34 1 5 30 21 27 35 26 12 27 1 1 44 13 23 1 13 2 8 49 2 35 47 12 1 41 10 1 24 1 26 1 1 43 37 40 23 21 23 41 21 6 46 22 2 28 9 1
1 48 12 9 38 2 8 49 42 37 43 15 1 1 39 46 10 25 34 20 25 42 15 44 28 3 29 41 1 12 44 1 42 2 33 39 37 11 1 18 28 16 40 24 1 9 39 44 1 1 48 45 1 39 1 1 23 10 4 22 31 1 32 1 46 1 10 48 20 31 1 33 20 1 22 19 4 39 29 41 25 3
43 8 3 11 23 4 25 9 44 35 1 49 1 8 44 1 3 1 46 1 1 10 43 18 27 9 1 23 28 30 1 45 8 49 30 37 16 40 15 6 16 40 4 1 30 7 28 1 42 19 41 49 43 14 1 1 10 1 10 41 1 2 19 33 1 29 8 33 26 9 1 8 32 49 10 26 48 45 25 1 28 50
38 41 9 31 4 2 41 34 1 19 1 37 9 9 14 1 30 34 22 25 36 37 30 1 1 44 40 1 25 40 1 1 35 39 22 48 44 4 32 22 23 30 1 43 25 50 47 48 12 36 5 17 24 1 45 34 15 30 42 45 5 10 24 9 27 8 1 1 6 19 39 32 33 42 1 35 21 13 28 21 1 1
7 42 1 33 1 19 45 37 17 16 18 18 42 28 45 1 1 42 36 8 1 30 1 45 38 29 9 20 48 30 35 1 1 34 6 17 44 15 9 1 25 27 34 23 12 1 50 1 1 31 1 35 5 40 21 11 32 1 1 40 13 5 8 36 29 47 38 18 19 28 36 26 1 21 41 23 49 8 11 43 1 13
9 45 33 23 26 7 1 9 17 43 37 1 22 47 8 1 1 40 7 1 18 19 42 8 1 8 26 31 38 15 10 48 24 31 34 39 7 49 17 7 11 1 1 29 1 6 1 46 45 15 27 49 1 20 1 50 5 49 1 49 1 25 29 28 40 40 11 27 44 1 48 12 19 39 15 1 1 4 40 11 18 37
31 48 10 33 45 4 19 21 1 41 48 24 49 23 20 50 48 1 2 25 7 42 2 44 32 42 13 46 35 39 20 1 26 22 6 35 1 8 36 7 47 1 1 33 1 29 20 37 27 1 37 34 37 45 6 38 26 48 1 22 14 28 9 6 11 26 40 2 44 18 25 1 34 48 5 32 1 28 47 41 38 1
1 7 38 8 2 7 39 1 23 40 11 41 1 31 3 45 32 22 1 32 4 20 4 24 47 20 1 1 26 28 10 1 45 21 16 47 27 39 15 1 23 36 1 4 13 39 1 38 41 27 14 23 1 1 33 40 1 12 49 1 1 36 11 45 25 1 26 1 16 11 46 28 41 39 39 27 25 1 1 18 32 30
25 1 14 23 37 40 22 36 49 6 21 8 6 20 33 8 1 37 1 34 26 1 49 33 29 16 24 32 4 36 39 29 1 49 34 11 19 48 17 25 32 31 13 12 1 1 1 44 4 37 43 5 32 38 28 1 22 3 1 49 38 23 1 44 8 35 23 4 42 16 1 13 36 12 1 1 3 22 27 16 4 42
27 27 28 9 1 37 1 1 20 23 26 29 38 10 28 4 47 27 9 3 42 1 1 34 8 1 42 24 16 6 14 10 1 42 1 31 1 4 1 23 21 31 8 31 25 12 1 1 10 10 1 9 11 8 19 1 18 13 47 4 32 9 41 1 19 1 39 14 1 27 49 1 1 47 27 17 27 21 44 48 26 11
50 28 47 43 1 35 48 17 11 8 1 11 42 11 9 29 12 1 1 19 1 33 49 1 24 1 39 1 42 3 14 41 48 1 18 26 1 17 1 28 20 45 1 9 39 29 30 24 12 21 1 50 1 1 4 15 15 32 1 1 44 1 38 41 46 1 1 38 40 1 1 33 34 27 18 24 29 1 1 7 1 1
35 31 13 1 41 18 1 6 36 25 2 1 34 3 1 45 41 43 13 23 36 47 35 47 1 2 7 1 1 1 44 1 1 3 10 8 5 48 50 1 50 5 24 42 45 23 14 1 22 20 1 1 5 25 25 33 41 25 50 22 36 38 10 16 40 21 39 38 47 23 21 37 34 31 20 1 39 11 13 1 20 40
1 1 28 37 18 1 27 12 5 1 1 1 30 22 3 16 8 14 1 4 37 38 41 43 1 34 16 36 1 33 17 34 1 26 13 1 35 19 1 1 43 1 17 21 14 10 7 25 15 35 1 18 14 1 16 32 20 22 50 43 32 3 7 37 20 40 11 42 7 1 42 8 32 38 1 33 7 46 1 12 4 20
31 5 3 48 25 1 35 29 1 10 39 24 1 28 35 22 27 39 1 13 48 1 22 1 30 7 14 1 7 22 29 29 8 1 44 38 1 19 29 1 36 20 40 19 14 24 12 1 14 6 35 5 7 44 5 23 31 24 31 1 1 1 38 8 1 24 1 8 1 8 1 50 7 39 34 25 14 21 40 1 3 8
9 8 1 17 3 1 1 19 13 30 19 48 43 43 39 43 24 21 1 30 6 32 4 5 1 36 15 36 36 37 26 9 8 28 43 9 11 49 49 1 24 31 19 1 27 1 44 9 33 22 36 8 6 8 36 10 25 7 43 34 36 4 1 28 21 43 24 13 27 11 40 1 20 1 6 11 16 49 18 2 5 19
41 42 11 30 6 5 21 46 23 45 48 13 14 18 45 1 23 50 20 18 22 39 41 16 1 12 21 4 34 8 34 16 4 1 14 22 1 15 13 46 45 1 1 1 1 2 25 50 28 46 14 41 22 16 10 31 41 10 1 16 1 31 46 50 8 25 18 42 49 1 10 16 1 47 14 1 43 13 5 39 29 1
25 1 24 30 14 1 48 1 24 1 49 34 10 23 19 33 45 1 1 18 9 1 43 38 29 26 17 36 16 1 25 1 1 2 25 26 22 1 1 1 1 1 10 19 36 43 3 1 25 13 19 12 37 1 2 6 18 19 30 43 1 19 1 44 17 50 23 22 4 49 34 47 48 14 9 31 31 15 18 1 27 1
1 44 21 12 22 45 27 1 49 32 17 43 1 2 6 1 1 43 14 43 15 49 18 5 1 6 8 1 30 8 1 37 50 50 47 46 1 24 13 7 31 31 13 44 9 14 30 1 17 32 49 41 9 17 28 42 1 1 4 30 41 22 1 42 40 33 31 25 6 4 33 34 50 44 46 13 18 9 24 16 31 45
1 26 1 41 3 1 17 22 35 41 40 1 42 1 46 36 1 25 13 1 20 33 29 14 29 8 48 2 47 3 48 38 34 3 26 25 20 28 44 1 29 35 43 11 1 1 1 25 7 44 39 1 22 13 28 1 15 1 38 4 1 14 38 1 46 37 36 20 17 9 31 1 20 24 40 25 11 21 1 4 4 1
23 29 1 16 1 27 25 1 40 49 41 17 1 34 5 34 1 17 12 26 1 1 28 32 1 1 9 1 28 50 1 1 1 42 1 46 20 1 15 45 44 25 8 13 18 1 46 1 22 16 24 5 48 1 21 39 40 30 1 35 1 32 47 35 1 30 13 26 20 42 39 12 30 20 5 25 16 30 1 1 42 41
6 9 21 1 41 1 29 49 1 1 1 9 9 41 8 17 35 13 31 8 23 14 1 21 17 1 23 35 32 1 28 37 2 25 37 1 7 21 43 41 50 1 5 1 41 10 10 3 1 35 30 21 4 29 1 46 15 1 8 1 22 47 7 35 40 1 27 13 1 29 48 4 44 15 13 36 41 27 24 14 25 6
33 44 38 41 13 8 4 16 49 46 1 21 1 1 1 3 37 16 22 2 24 26 8 20 17 41 18 1 1 10 1 31 2 1 45 44 24 14 34 46 49 1 6 49 26 10 44 1 50 28 46 16 47 11 25 35 36 39 1 44 39 18 24 50 45 10 1 23 41 20 30 28 1 27 1 8 1 16 3 23 44 1
13 14 11 45 32 43 4 23 46 1 25 15 29 30 47 49 33 40 31 1 12 19 18 49 3 27 44 5 1 7 1 50 26 9 1 37 1 17 1 49 42 5 23 2 25 42 2 35 14 39 34 26 2 35 22 10 30 15 48 18 19 49 25 24 35 35 37 1 1 26 24 25 8 16 13 24 37 6 1 1 26 41
13 26 1 28 45 13 24 17 30 4 10 1 3 1 26 1 15 16 39 11 32 28 31 17 18 2 36 24 37 19 3 7 1 29 1 47 9 1 43 1 23 1 6 30 33 8 5 4 7 40 44 1 1 7 1 10 41 47 3 15 34 29 1 42 40 1 29 22 25 41 1 31 1 16 33 1 37 16 29 6 28 35
1 26 1 28 1 44 12 46 42 1 7 1 18 11 41 7 12 1 6 23 1 21 29 36 50 1 1 27 21 1 47 1 7 32 32 11 40 21 1 36 1 38 23 1 1 8 40 49 24 49 33 50 11 1 28 3 9 1 1 17 9 33 4 40 30 31 19 42 40 1 37 30 48 38 38 40 1 44 17 1 40 48
19 47 44 45 3 17 14 1 32 38 35 18 43 31 16 1 13 4 41 1 42 1 1 1 15 11 7 44 23 18 45 39 1 34 16 45 45 1 49 41 1 1 14 34 1 1 19 1 1 40 31 22 46 33 36 1 50 1 20 13 46 41 44 33 1 1 1 15 10 3 17 1 8 37 1 23 31 1 1 1 12 18
7 1 16 9 3 1 1 25 1 10 35 38 35 14 23 36 39 12 22 21 1 38 33 36 27 10 12 24 1 31 18 1 23 5 13 27 26 18 1 9 37 22 1 2 1 27 30 36 37 3 1 48 1 1 45 1 1 18 1 1 43 38 1 38 16 6 27 5 19 1 1 24 49 1 42 24 1 36 1 1 50 1
24 37 11 50 1 20 45 1 3 6 1 44 11 1 2 38 30 1 1 9 41 1 48 1 37 13 18 29 30 1 24 34 32 7 25 28 1 1 41 45 22 44 47 47 43 23 1 1 39 1 33 7 8 13 11 23 39 1 1 18 1 40 25 26 1 23 24 8 29 15 44 1 41 41 5 9 33 34 25 33 19 5
22 1 8 4 50 26 37 1 31 1 1 1 11 45 16 40 45 2 45 44 15 2 45 10 1 40 42 19 1 26 50 2 16 48 18 32 28 37 1 42 37 36 29 16 21 35 14 48 46 1 36 1 46 1 46 1 10 15 12 1 38 27 1 1 10 1 1 1 45 32 1 1 43 32 40 27 38 5 5 22 19 46
20 36 21 34 39 13 25 47 32 12 1 13 16 1 36 6 5 1 47 5 8 39 29 38 21 46 20 1 9 26 1 28 31 43 18 31 50 2 14 10 42 25 1 12 24 47 47 28 1 33 1 26 1 1 16 34 1 28 1 2 33 1 12 11 46 13 1 1 3 42 48 30 1 1 1 20 24 18 1 1 4 33
13 25 1 1 22 43 1 25 1 26 36 42 32 1 14 1 29 45 38 41 43 1 29 1 48 38 37 16 3 49 48 11 19 1 1 1 30 14 14 28 33 39 29 50 20 20 1 6 33 11 6 27 1 1 38 25 33 6 1 35 11 10 28 10 20 19 37 28 20 3 35 46 14 1 17 14 1 1 30 41 41 32
1 30 3 28 29 47 35 31 1 31 18 10 1 25 8 13 18 12 1 1 50 48 42 11 12 48 1 2 31 11 47 35 17 22 1 12 34 46 33 8 19 42 30 46 39 19 8 36 19 1 30 42 30 30 1 39 42 1 5 5 1 38 18 1 1 24 47 3 42 23 5 7 41 1 24 28 41 39 48 4 36 1
49 35 1 16 1 40 47 38 1 12 12 1 15 8 32 1 50 1 43 47 7 1 27 6 41 43 1 34 1 25 20 10 28 49 31 9 19 27 44 1 17 25 39 48 48 22 27 1 14 44 1 24 12 1 37 35 50 1 14 1 17 18 24 41 44 1 19 29 44 1 18 31 49 2 1 32 18 36 39 45 27 46
6 1 33 19 21 11 20 14 26 42 48 1 38 1 33 31 1 40 15 44 34 1 4 1 10 31 37 36 11 1 12 26 12 50 40 9 31 32 27 41 8 16 1 12 1 13 15 4 43 35 44 17 35 21 1 35 1 11 38 37 29 47 1 45 33 31 23 3 1 33 11 43 44 30 1 42 1 9 1 16 1 2
1 50 15 14 40 27 31 4 27 50 1 46 29 43 13 17 17 15 1 40 38 25 31 16 49 32 46 45 6 40 41 20 21 28 1 23 1 1 46 41 37 26 25 45 22 8 1 1 38 47 1 3 13 23 1 12 35 1 39 45 5 7 19 34 29 31 1 46 35 33 1 32 11 16 20 1 23 1 48 46 25 14
13 27 1 45 35 1 25 12 2 17 19 50 14 4 19 25 13 1 2 49 48 1 38 33 39 44 1 11 36 22 32 1 1 1 1 1 9 23 32 1 40 1 1 32 21 28 1 30 36 23 1 11 1 47 1 50 32 31 32 33 22 23 39 25 29 30 24 38 10 27 40 23 18 11 19 10 4 26 38 1 31 48
1 40 10 8 1 5 19 5 34 1 22 49 11 28 36 1 5 25 43 24 35 2 1 1 1 46 1 28 2 5 33 42 1 15 30 1 1 43 48 32 1 11 36 1 4 1 9 43 49 8 9 36 49 39 38 1 12 1 25 27 6 18 4 48 45 1 1 24 46 48 35 9 12 1 7 28 22 33 1 1 1 41
44 36 7 5 18 1 1 35 20 32 18 34 1 12 8 48 49 18 1 26 39 19 43 1 22 10 15 1 39 33 1 1 1 16 19 4 32 36 44 10 49 11 38 1 5 13 28 28 43 27 17 47 23 35 38 1 44 1 32 47 24 14 27 28 47 23 37 12 1 34 18 41 31 15 1 48 1 1 1 33 48 5
1 36 48 12 47 13 38 1 20 1 1 1 36 1 1 5 1 43 1 29 7 1 29 23 21 6 48 48 1 37 15 1 24 16 1 31 1 20 8 31 4 1 1 1 27 1 1 1 1 16 4 1 29 31 9 48 16 1 1 30 41 34 49 3 21 41 47 17 44 21 4 17 25 33 18 49 1 34 36 1 30 1
21 14 13 26 10 44 35 31 26 10 1 29 46 38 28 13 11 22 1 1 38 19 14 31 5 12 13 1 42 1 48 25 1 26 34 41 49 39 29 37 1 3 39 12 13 10 25 44 49 43 1 30 40 1 1 37 34 17 39 38 44 32 12 29 1 20 31 6 1 19 50 1 1 1 40 20 23 6 6 1 1 1
23 1 1 32 4 41 23 1 25 34 47 8 5 42 6 41 9 33 18 50 21 14 35 35 20 21 43 21 1 50 49 28 1 5 1 41 1 1 23 26 20 1 41 41 12 27 26 1 37 49 25 21 1 1 37 26 24 41 28 15 14 33 25 46 33 19 28 23 17 31 1 15 40 1 1 39 1 4 21 18 24 33
39 8 16 45 4 19 1 19 16 36 16 41 1 23 26 38 47 23 25 31 1 48 29 29 31 1 41 35 1 2 50 1 1 1 1 35 12 30 48 3 32 3 8 1 2 5 1 7 45 20 6 1 16 29 44 18 3 18 32 45 38 39 1 1 5 1 15 37 1 26 18 17 32 4 24 4 1 35 18 15 18 14
33 24 5 1 43 44 9 48 3 44 36 19 4 2 33 48 6 32 1 1 1 29 45 42 12 40 1 11 15 25 1 33 4 9 10 4 40 21 20 23 4 35 32 46 1 31 18 14 20 33 44 1 19 46 39 28 10 33 50 3 1 18 10 7 38 13 6 1 1 22 33 36 1 28 36 1 1 1 28 38 1 11
34 41 1 24 1 20 1 4 39 22 42 18 34 46 3 15 40 1 38 1 40 22 1 20 1 18 19 1 47 7 16 21 14 48 42 29 1 3 1 27 24 17 3 29 23 1 21 15 48 5 49 42 24 33 31 47 45 1 1 50 48 3 45 14 39 42 25 27 36 30 48 13 1 11 14 36 1 21 46 35 23 39
3 6 1 12 36 26 31 48 7 1 37 29 34 47 26 20 12 26 13 40 25 2 30 27 28 48 5 35 39 1 1 28 1 5 18 16 34 19 31 1 18 11 39 5 5 2 43 4 33 1 48 4 5 1 36 1 32 22 35 2 11 23 47 1 43 1 24 29 11 44 34 19 35 4 36 44 39 39 10 4 35 29
18 31 18 1 21 14 37 44 43 18 28 36 1 26 44 13 22 40 12 12 38 21 24 49 11 1 17 5 32 1 1 9 1 6 44 1 45 1 33 1 18 1 1 43 50 18 22 10 10 1 1 44 32 50 38 25 28 1 11 21 50 49 8 6 25 10 44 10 1 1 1 16 29 5 34 4 27 1 36 38 38 37
18 13 22 17 46 23 48 50 50 8 43 1 24 22 1 1 28 1 1 30 14 48 10 1 48 34 10 10 34 34 48 1 27 29 1 8 1 42 39 2 1 1 50 7 47 1 1 16 37 8 37 29 33 40 2 23 22 1 17 43 5 13 1 1 1 9 1 16 7 11 29 6 30 15 47 47 17 1 33 45 6 1
29 42 39 35 1 22 49 42 28 26 1 32 42 7 17 1 1 30 28 36 13 50 7 34 15 35 14 30 5 38 32 1 1 26 11 9 1 26 44 21 35 25 7 34 5 34 46 14 19 30 37 1 43 5 32 2 30 23 15 48 20 10 2 1 1 40 32 4 41 1 33 27 1 42 1 2 41 22 19 35 16 3
39 25 45 1 1 35 50 42 45 8 41 13 45 1 16 10 28 3 20 50 4 11 26 1 22 3 30 50 49 22 12 26 23 1 2 5 50 27 1 37 1 23 48 35 18 1 42 11 46 46 49 20 21 50 47 27 28 38 42 38 35 30 20 4 29 44 29 50 13 29 46 48 1 38 6 31 15 24 4 43 38 1
32 1 39 12 49 41 27 37 34 39 26 30 3 42 44 1 42 11 36 1 6 49 30 17 19 28 28 1 1 44 35 3 5 28 28 44 10 3 36 44 39 21 1 34 44 39 1 34 46 1 1 11 18 31 40 46 27 24 12 17 30 1 17 7 3 41 10 4 10 1 7 1 40 12 36 49 1 48 11 1 1 5
27 34 5 50 6 17 1 3 45 16 40 31 7 50 14 37 45 22 20 40 1 1 8 1 29 22 13 24 1 15 1 39 46 45 29 12 8 1 34 14 22 19 48 10 1 44 28 1 9 1 1 1 15 25 42 42 21 1 17 15 8 4 1 1 41 27 34 28 14 48 1 36 23 1 14 1 39 31 1 23 16 1
1 1 1 1 13 1 1 5 45 1 1 1 26 6 43 1 12 1 27 6 20 1 48 3 21 39 3 42 3 1 20 13 17 38 7 40 1 19 47 30 31 32 1 7 1 16 1 48 2 15 7 45 5 1 38 1 11 32 42 19 44 1 1 28 4 25 42 1 1 48 49 34 1 1 7 45 15 40 35 45 12 12
3 31 33 20 12 9 24 9 35 13 43 26 49 1 20 10 49 9 39 13 27 1 1 1 2 27 50 28 12 14 1 18 30 1 22 29 1 6 46 35 26 1 33 18 21 4 35 16 1 19 11 1 45 1 38 12 29 1 1 42 8 11 47 28 1 1 29 18 1 11 1 29 6 48 29 19 1 12 9 11 35 17
40 1 38 35 41 46 10 19 38 4 1 1 1 23 39 15 32 18 43 25 1 38 1 1 1 42 1 30 31 39 23 1 45 9 34 1 1 1 40 27 34 13 44 19 8 1 26 1 21 10 8 1 1 37 23 1 41 22 1 40 1 5 41 43 41 2 43 4 35 14 31 48 4 1 47 15 30 19 21 42 46 1
46 40 1 50 49 27 1 8 15 49 1 23 27 17 14 1 8 36 7 10 27 1 16 1 20 20 2 7 9 1 20 33 37 38 17 11 47 1 38 1 26 43 1 1 50 1 21 42 39 24 35 30 6 29 24 28 1 1 49 44 40 26 27 1 48 31 1 14 1 2 31 1 1 44 1 9 45 4 1 27 17 10
