52
11 20 36 44
45 38 5 17 44 49 1 40 4 27 31 1 32 49 38 49 27 43 43 20 4 26 16 1 25 18 1 35 46 24 1 1 31 1 47 4 19 49 12 42 3 1 19 45 30 22 15 1 28 48 1 12
16 9 1 1 13 1 1 31 3 19 21 45 9 30 1 8 12 21 1 33 1 1 11 29 21 22 18 40 1 1 1 38 39 16 1 1 45 1 6 5 40 49 1 49 1 4 1 17 18 15 1 1
1 18 14 1 1 40 33 26 25 1 18 33 29 1 1 9 3 2 21 1 5 1 44 43 47 27 34 37 1 47 1 31 48 35 40 48 49 5 22 42 1 2 37 1 9 18 34 29 6 17 41 1
43 1 48 33 47 50 31 1 35 14 43 42 41 27 46 13 4 10 41 34 4 23 1 2 9 20 30 18 23 11 45 1 12 40 36 28 1 2 1 12 23 24 12 19 6 17 26 35 35 1 12 15
1 4 25 31 1 22 46 11 47 30 30 45 1 1 42 18 2 16 43 27 42 18 1 1 1 50 27 5 45 36 43 2 47 13 25 33 31 14 43 1 28 20 5 6 7 11 1 39 29 46 1 13
4 40 42 4 19 11 20 21 34 29 1 11 28 16 32 35 1 18 31 49 1 48 2 31 45 29 49 32 24 1 43 2 1 37 18 44 25 40 22 1 13 40 28 8 7 11 4 4 50 37 7 1
1 1 32 43 16 1 23 25 5 6 1 15 24 1 1 25 18 1 29 37 1 3 4 39 22 4 1 1 19 1 44 1 44 30 15 1 1 27 41 2 49 34 41 12 42 24 40 35 1 6 1 17
34 15 44 1 2 43 16 1 47 9 30 27 26 5 18 22 1 47 20 19 45 21 1 45 39 40 41 33 8 18 1 1 39 25 32 45 13 32 3 26 1 1 23 1 14 29 1 37 1 9 47 38
26 48 1 15 31 22 11 1 19 6 1 39 1 36 1 21 1 27 48 21 19 49 24 37 25 34 48 38 1 26 21 28 29 25 12 26 49 10 29 27 33 40 33 16 6 12 9 23 40 17 12 1
48 43 42 50 22 1 7 28 1 16 14 33 45 49 1 46 7 32 6 1 1 1 1 1 12 7 14 6 19 44 10 41 10 1 48 42 13 24 17 1 42 3 28 5 47 1 39 18 22 37 32 23
35 19 1 15 22 4 1 43 29 3 49 43 50 49 33 46 13 20 1 50 1 17 47 22 21 12 38 2 19 7 2 49 26 1 28 46 14 1 1 26 22 47 41 1 39 49 30 34 1 1 50 1
10 1 32 1 9 41 35 22 42 5 5 1 28 40 1 1 48 6 37 46 37 1 20 1 8 1 1 33 1 18 5 1 1 43 31 27 1 1 41 15 36 1 10 34 17 7 1 1 45 1 2 1
27 38 41 44 41 21 14 34 19 38 34 1 1 1 10 42 49 33 8 39 23 38 1 11 1 1 4 35 10 28 11 13 6 25 7 4 14 49 46 13 3 42 32 26 27 28 40 40 15 1 27 46
36 30 30 18 20 11 42 44 35 1 1 25 39 1 4 1 48 41 1 2 49 44 38 22 8 34 1 39 11 22 1 20 1 2 49 25 13 1 31 1 1 1 7 9 20 20 1 38 1 44 5 1
44 41 20 29 10 27 1 3 19 28 47 43 41 26 22 31 10 43 45 33 22 42 12 49 20 30 11 1 4 44 23 47 42 5 42 1 34 22 46 46 28 1 2 1 1 1 1 35 5 1 12 27
43 11 39 38 18 1 1 3 48 8 1 21 1 41 1 38 30 42 29 35 1 36 45 22 3 49 9 11 19 42 1 10 11 36 1 11 28 18 6 1 1 45 43 20 50 1 27 20 4 25 18 2
1 36 1 24 27 1 37 1 7 32 15 1 45 1 21 6 22 28 1 44 1 36 22 32 28 5 1 36 39 1 39 12 31 48 49 8 49 1 50 17 6 1 24 25 1 39 6 19 10 1 48 40
8 42 32 5 28 46 17 48 40 25 49 24 50 31 42 1 22 45 40 36 1 50 1 1 41 14 5 10 35 41 33 43 31 41 18 35 29 8 2 30 27 1 34 1 38 31 38 13 1 1 44 27
15 8 36 18 1 10 1 47 1 20 10 30 34 1 16 19 44 48 2 19 42 18 25 28 15 4 17 32 37 1 3 43 1 20 1 20 1 35 16 2 12 1 30 18 1 14 1 23 36 1 6 1
36 1 8 27 21 1 27 1 36 31 28 1 29 9 41 2 41 33 9 8 49 48 23 25 1 35 3 1 2 27 1 2 11 12 48 42 1 33 1 30 47 38 1 7 50 7 1 1 28 45 1 24
8 1 20 28 13 31 36 34 39 46 21 8 34 2 27 18 1 28 1 22 4 4 21 45 37 39 5 2 39 48 9 7 48 9 1 50 1 7 1 16 24 1 1 1 21 14 10 1 5 1 23 25
30 49 1 7 1 22 19 10 14 4 1 50 11 1 1 1 1 20 35 46 42 14 29 15 43 43 44 40 50 1 32 20 7 49 32 14 1 5 1 19 46 49 1 21 44 34 40 1 30 1 9 28
50 47 1 1 45 44 47 1 32 44 1 17 10 3 15 15 3 1 35 9 1 5 41 1 9 17 20 1 1 1 43 13 1 1 8 1 1 36 10 1 32 7 27 16 46 14 37 38 1 30 1 1
10 1 25 26 24 20 1 2 32 1 1 49 44 4 1 14 15 24 15 39 50 1 20 46 1 41 31 1 10 6 35 1 40 1 42 41 25 36 13 22 15 38 1 35 3 20 30 1 29 48 41 1
1 28 37 2 27 32 32 1 43 12 35 31 31 7 23 27 9 34 37 46 19 3 44 22 29 25 9 1 38 1 10 28 16 24 8 1 32 42 3 48 38 40 46 25 23 1 4 48 15 36 11 17
44 38 19 50 28 17 1 21 16 10 5 1 23 48 3 1 1 15 27 6 3 38 30 41 1 19 41 1 1 16 1 28 22 21 1 17 46 1 47 4 1 1 29 38 42 45 47 30 6 32 38 30
43 1 24 29 48 44 25 16 8 1 30 46 1 8 1 47 35 48 1 27 43 14 14 6 42 38 48 42 46 33 34 29 1 46 13 34 18 3 9 15 17 10 1 36 43 1 3 25 9 10 20 27
46 1 22 44 37 35 23 45 1 1 11 1 32 1 7 9 32 15 30 1 1 15 32 12 38 13 34 2 1 24 35 1 1 42 1 19 1 30 26 41 8 35 21 1 1 3 29 1 36 39 40 50
1 36 21 44 7 30 40 9 9 11 24 28 16 49 6 15 23 47 20 44 1 25 1 1 1 35 26 15 16 22 38 42 46 36 1 11 38 13 10 49 14 11 1 15 2 34 1 38 39 41 12 50
1 1 7 21 11 2 1 1 1 23 21 5 5 9 42 1 30 29 27 23 48 21 39 10 28 1 24 7 37 23 38 27 23 33 1 48 31 10 1 38 43 31 17 1 40 29 35 7 30 18 26 40
1 18 40 34 7 15 40 11 2 40 6 1 1 47 19 36 23 1 1 27 16 1 14 36 28 29 33 47 43 1 20 30 31 9 20 1 36 12 10 1 1 1 15 29 49 47 1 45 46 24 10 6
41 12 46 29 1 1 18 4 33 32 1 23 23 40 1 1 1 1 23 1 9 32 1 13 3 8 25 22 1 11 32 1 1 1 49 1 43 45 21 1 50 12 43 38 44 1 4 10 7 48 1 1
3 44 1 39 36 39 9 50 1 1 12 7 44 22 15 47 1 26 19 8 19 10 45 20 39 9 12 35 40 2 40 18 10 6 37 48 46 1 10 28 2 27 37 39 6 24 41 36 36 24 1 1
50 15 12 18 46 2 39 41 1 30 1 28 29 26 42 1 36 41 1 3 44 1 24 5 18 22 1 49 19 31 6 41 2 1 1 39 29 10 1 38 45 1 33 1 32 8 30 1 8 45 25 44
29 1 33 18 26 50 1 45 29 1 25 34 1 37 1 4 1 16 43 22 1 34 41 45 1 45 1 14 7 7 28 1 25 45 1 2 38 10 1 21 48 2 27 18 13 1 38 24 38 1 1 47
40 1 16 29 18 3 22 17 21 35 25 8 39 29 1 29 33 5 39 34 1 4 47 23 33 7 1 24 49 47 25 25 49 32 1 45 1 1 29 46 8 10 11 7 19 35 17 29 36 30 1 43
1 27 17 10 46 18 41 33 47 16 14 13 29 48 47 45 14 9 50 34 1 44 1 50 24 14 32 10 1 28 2 1 1 11 47 18 1 31 37 37 1 15 28 1 33 1 49 22 41 5 8 1
1 15 33 16 18 1 42 27 30 1 47 1 7 12 4 19 29 1 40 27 35 1 1 46 17 1 12 20 1 33 29 47 23 20 24 4 3 2 43 24 45 1 25 29 22 40 1 2 1 49 41 11
1 24 40 43 27 36 1 38 1 1 20 1 49 12 15 1 7 1 35 26 9 23 33 9 7 14 42 30 35 22 1 19 35 13 36 1 49 1 37 36 21 28 2 42 43 1 1 32 13 7 7 1
33 36 38 1 1 31 30 44 24 40 43 1 8 20 1 14 44 49 11 10 28 48 42 10 44 28 1 46 1 1 28 41 24 1 47 22 39 40 1 17 1 19 1 10 14 33 1 1 21 1 22 43
1 39 40 5 44 12 50 21 1 13 1 27 26 26 1 1 34 27 2 1 11 19 1 13 15 42 24 5 45 3 10 30 27 30 2 10 45 49 6 44 41 21 11 10 22 20 16 42 1 40 28 1
3 20 1 4 1 9 1 3 31 16 1 41 1 1 49 43 3 9 34 49 11 41 20 50 26 1 44 14 24 31 3 1 1 11 32 33 1 1 22 26 1 17 1 5 3 27 27 21 9 1 19 1
46 35 32 22 46 47 1 18 24 1 1 1 32 47 49 1 17 27 1 30 44 4 14 37 44 34 1 45 1 1 40 6 1 1 16 1 45 47 33 1 1 12 34 18 39 20 36 1 4 28 1 3
1 29 38 41 28 1 23 1 22 1 34 1 15 21 1 1 1 8 18 27 18 16 34 3 44 12 35 28 26 47 1 45 1 8 31 44 12 5 48 2 23 46 10 5 1 8 1 15 8 1 45 19
45 20 19 34 1 1 47 44 17 1 13 42 29 19 37 12 21 49 34 13 23 19 5 4 16 47 1 47 14 49 1 33 25 23 1 1 1 1 1 23 1 5 1 38 1 1 30 1 28 39 5 17
36 1 15 20 39 14 26 29 20 39 37 6 26 9 25 25 12 15 35 36 9 42 22 1 38 29 24 48 44 49 48 47 30 1 16 1 43 48 14 1 41 34 18 25 1 1 15 34 1 30 2 47
8 21 8 16 41 1 24 1 36 15 29 43 1 1 1 50 11 1 1 23 1 21 1 27 1 1 35 21 28 35 1 2 40 5 41 20 1 1 19 1 6 48 35 30 28 6 13 14 11 26 42 6
4 1 1 37 33 16 28 9 13 1 19 49 14 1 16 16 34 47 1 44 10 48 37 18 25 22 44 21 26 32 46 15 4 45 18 24 1 33 45 17 39 13 16 19 1 47 2 45 35 31 39 15
21 1 11 37 2 31 19 27 29 7 26 8 3 21 20 1 30 28 47 15 3 42 12 27 29 32 2 1 40 11 19 22 23 10 50 35 14 23 7 26 6 1 1 8 1 1 2 17 23 18 21 15
26 40 5 1 1 6 47 39 45 23 13 26 40 39 6 47 15 45 37 43 50 41 1 40 32 50 1 42 26 28 34 41 50 14 20 33 23 19 38 32 1 1 26 33 1 20 26 2 16 2 35 1
31 45 1 1 27 5 1 9 6 16 1 25 42 33 1 44 1 1 9 1 13 29 1 21 26 36 4 22 35 26 2 13 45 46 29 23 19 34 47 15 40 18 1 49 7 16 13 20 30 19 22 25
19 43 22 7 1 16 46 1 45 39 45 25 42 43 1 50 8 48 1 11 38 1 1 42 28 1 1 1 37 19 38 38 7 44 47 13 1 5 48 6 2 33 1 3 5 1 20 45 46 39 42 14
