93
23 2 28 81
22 44 44 1 24 22 44 42 4 26 1 9 14 19 1 1 27 4 3 35 24 24 1 26 18 1 4 21 16 48 11 23 25 38 40 9 34 46 12 15 31 31 1 3 1 41 15 39 15 8 16 1 48 50 19 1 28 27 30 1 1 34 13 40 49 46 36 29 39 37 14 49 46 45 39 11 30 1 16 15 5 23 23 5 41 6 4 1 1 12 16 32 1
42 39 45 1 22 30 1 1 1 39 1 5 13 1 5 6 43 15 47 23 38 1 5 1 27 16 26 47 4 30 45 1 3 3 1 5 5 1 28 21 44 17 42 1 26 1 7 31 28 39 1 47 44 41 1 26 49 1 22 6 10 17 30 2 42 40 26 1 35 43 42 47 35 25 8 14 36 4 35 15 1 4 1 41 26 15 4 24 17 38 9 34 49
8 42 37 25 1 1 49 24 30 35 39 28 15 21 45 37 1 13 1 1 21 21 5 33 48 27 40 35 9 11 11 21 46 7 10 30 1 38 32 14 8 48 31 44 35 13 5 18 1 1 20 48 31 39 48 11 20 9 28 26 8 34 45 3 3 1 13 50 43 32 38 48 24 28 15 7 35 1 1 15 19 2 37 17 32 19 20 1 15 1 17 43 45
17 1 25 22 1 1 1 25 4 49 21 1 38 36 1 43 1 1 8 1 26 17 1 43 44 34 17 45 1 4 40 1 8 40 21 49 24 15 29 1 11 1 1 12 11 6 26 49 44 1 50 34 35 10 19 43 17 45 40 41 42 48 41 32 16 9 38 45 1 1 1 47 1 36 16 1 12 16 10 5 48 47 48 4 28 42 28 3 17 6 45 9 44
42 43 19 44 7 17 25 11 1 33 5 37 27 1 10 31 1 3 6 1 2 32 1 26 1 37 10 1 32 41 48 1 25 1 1 12 1 1 34 27 47 16 40 18 1 49 1 1 10 39 46 1 25 1 13 1 32 1 1 44 19 1 41 9 1 1 47 20 23 12 46 20 5 18 11 21 1 44 41 19 1 28 29 49 38 16 41 8 42 16 7 42 42
40 9 5 26 3 28 1 40 10 32 26 44 24 31 5 15 34 29 35 43 36 17 38 6 38 2 38 22 19 27 12 32 19 22 1 10 5 50 1 1 37 18 24 48 44 1 14 11 21 22 1 1 33 1 48 11 36 50 1 7 29 28 1 24 20 9 36 30 1 43 38 43 37 1 36 27 36 44 34 13 24 46 14 47 41 1 27 1 34 1 1 13 1
32 1 32 1 37 19 19 1 50 28 35 26 4 29 39 46 18 46 3 1 25 48 1 46 17 29 1 1 22 42 34 1 17 50 1 38 25 29 1 18 10 1 5 13 18 19 1 1 18 39 8 46 30 1 26 13 29 20 41 32 5 40 3 1 23 1 50 17 50 39 2 37 18 1 20 48 16 6 8 14 48 42 23 1 5 23 1 3 18 43 23 5 32
1 1 18 40 43 34 6 1 1 14 21 43 36 27 40 34 27 32 45 1 23 27 42 42 1 22 28 4 23 1 35 17 1 1 16 8 36 28 13 1 17 29 2 1 42 4 19 36 1 34 6 49 9 39 48 6 41 42 19 40 37 28 10 33 1 35 10 36 8 47 33 1 45 1 10 23 35 5 1 42 43 1 11 40 11 1 31 35 1 35 16 13 1
19 21 34 1 26 2 38 17 8 50 14 50 10 47 11 11 15 1 22 22 1 6 11 1 47 35 12 1 1 38 2 42 24 12 5 4 50 45 39 44 36 5 4 3 4 28 1 1 44 32 11 15 30 16 1 48 44 2 27 30 43 15 8 42 33 27 10 1 15 43 39 18 17 1 13 20 1 39 1 21 22 20 21 48 17 2 21 30 48 9 1 6 50
43 34 8 29 28 1 46 8 1 1 35 20 11 27 49 1 37 1 17 10 4 1 7 1 25 38 12 2 43 35 1 1 7 48 48 1 17 39 1 1 26 48 11 30 3 26 43 1 18 44 27 1 41 1 46 1 9 18 21 24 14 46 47 19 29 1 22 1 45 34 1 11 1 1 33 13 24 29 28 15 8 27 25 50 22 41 35 28 26 43 6 1 37
1 13 37 38 23 2 12 34 35 17 39 3 33 1 35 33 15 1 4 26 14 43 1 3 20 26 21 11 37 26 29 14 12 4 2 1 1 26 1 37 19 49 13 2 49 41 22 4 10 8 1 10 29 23 9 45 30 11 47 20 12 8 32 1 1 49 38 23 41 40 6 39 1 9 37 2 1 18 41 35 13 27 39 1 42 1 20 10 1 18 10 22 26
19 6 32 5 1 5 28 21 2 21 14 30 28 10 19 49 1 49 42 18 3 9 1 48 33 40 1 3 32 31 1 40 1 40 48 5 17 46 30 1 28 48 11 5 1 16 46 12 48 12 1 31 13 6 43 5 43 25 10 14 1 16 11 48 41 1 31 1 33 12 4 50 11 36 5 49 1 27 28 3 42 11 48 42 50 23 40 1 25 1 23 50 35
27 23 44 3 15 47 1 4 44 36 13 12 1 1 44 44 31 6 43 49 22 48 12 3 28 38 1 29 20 14 33 1 29 1 43 21 15 41 12 19 1 44 43 13 1 3 33 40 1 4 1 31 1 35 40 10 9 4 1 15 2 27 31 49 37 1 34 1 1 1 1 29 39 13 40 41 28 9 20 1 24 21 13 3 9 1 17 38 46 38 1 24 49
42 1 50 26 14 35 39 43 1 26 34 3 48 1 27 1 33 49 18 1 25 43 36 1 21 1 1 23 8 1 16 45 40 41 33 44 47 23 1 1 8 39 1 1 1 24 43 42 1 13 37 37 35 40 33 30 1 49 14 1 21 21 14 20 49 5 46 6 20 1 1 24 10 49 1 1 35 49 1 1 8 30 43 1 33 38 8 25 50 10 2 29 29
1 15 33 5 31 1 21 1 20 45 11 35 6 41 14 1 1 34 27 30 23 1 30 9 2 3 4 24 22 38 37 32 46 46 14 45 47 1 1 1 24 5 26 1 1 28 42 12 1 1 8 5 19 5 26 12 15 36 1 44 26 33 30 40 5 9 6 41 13 50 40 9 45 11 40 48 22 18 4 1 50 5 42 48 1 1 50 6 24 1 2 6 6
1 29 7 1 13 4 16 30 2 40 26 1 1 49 32 37 20 1 13 6 36 36 16 1 22 28 46 13 44 32 18 40 37 50 1 43 4 3 27 19 8 30 17 43 15 49 2 25 20 1 19 1 39 29 1 44 1 47 1 1 49 42 1 13 20 2 46 15 44 1 10 13 19 41 26 37 1 13 8 3 24 44 7 44 35 45 25 19 1 13 15 22 33
34 42 45 43 1 14 1 26 1 38 36 45 45 50 6 44 28 50 15 17 1 1 47 26 1 20 1 32 12 1 13 18 50 1 1 20 7 1 6 29 21 38 46 27 17 28 6 38 45 17 50 1 11 2 39 16 9 42 26 48 14 1 23 49 31 35 45 40 4 1 1 41 14 38 37 18 1 1 34 24 15 1 31 44 4 47 33 1 18 19 24 39 42
40 45 43 10 1 20 1 1 19 34 49 1 4 6 34 2 1 30 42 22 6 1 12 8 24 30 1 7 1 37 44 34 1 17 4 38 28 1 1 29 40 3 43 1 39 16 45 1 40 35 1 14 44 1 34 1 29 1 43 1 1 42 25 7 14 2 31 17 12 1 25 39 1 1 46 5 26 2 12 44 31 10 6 24 1 1 45 16 4 5 7 30 31
20 12 42 27 19 17 33 47 41 14 10 21 34 1 9 1 1 45 9 1 22 38 38 31 30 45 1 36 30 4 42 1 16 43 31 34 4 20 13 42 48 1 36 24 38 16 8 27 1 35 37 35 1 42 2 10 31 1 6 8 1 19 19 22 39 39 35 8 48 8 1 39 1 13 5 12 15 16 31 36 33 22 7 17 1 1 18 6 29 4 40 34 1
40 27 1 35 4 3 27 1 30 1 3 31 1 1 31 24 25 1 1 34 32 43 1 38 39 19 32 1 11 11 1 20 1 8 1 13 10 37 24 43 11 26 1 18 1 25 34 44 1 38 1 42 16 22 41 1 2 13 1 1 23 1 15 41 45 31 42 38 1 1 49 1 15 31 1 1 1 46 11 7 19 28 27 35 27 1 31 48 1 38 2 35 1
39 48 1 24 1 1 45 9 8 4 5 31 26 1 37 50 1 3 13 23 9 1 1 41 42 1 40 1 50 43 20 1 50 44 1 24 44 5 1 19 20 39 46 26 1 6 15 21 36 7 34 1 7 21 1 45 22 5 7 44 1 1 1 49 41 12 40 11 1 42 20 1 9 1 1 15 46 1 1 46 32 5 16 32 22 19 22 14 14 31 36 8 9
21 1 1 35 50 1 1 6 23 1 38 1 1 23 1 21 25 1 1 1 1 6 5 38 42 14 29 7 34 2 1 1 34 41 29 39 40 1 12 41 14 6 20 32 4 50 1 9 34 46 10 37 1 16 18 20 35 33 45 35 12 34 39 1 50 43 15 13 2 24 45 21 1 27 1 42 13 1 46 14 18 38 43 21 31 19 30 1 4 2 42 33 4
19 43 1 29 44 49 33 1 30 1 24 50 24 1 38 22 1 29 45 25 25 27 48 1 17 37 12 1 11 12 1 1 44 1 1 1 47 7 41 3 1 1 45 41 46 1 7 40 46 11 37 5 24 1 33 4 1 1 33 21 21 41 19 35 1 24 1 8 5 34 3 1 36 1 5 50 1 31 45 36 47 24 20 1 45 26 27 28 46 13 46 14 45
9 15 9 25 3 1 1 19 45 1 49 15 5 11 1 3 4 32 1 1 42 1 2 22 1 43 3 14 41 7 1 1 28 36 21 1 22 43 40 17 9 1 16 1 1 1 5 42 41 41 1 10 19 48 34 39 21 21 40 18 44 1 30 22 13 16 1 27 2 30 22 36 16 44 17 49 19 26 29 29 30 27 36 14 41 32 1 13 1 1 15 3 22
1 1 30 21 20 34 20 16 4 42 1 1 12 17 6 1 22 1 29 39 1 23 46 29 24 6 17 20 17 10 3 1 49 1 1 8 45 6 44 1 42 19 1 5 1 17 49 23 3 1 32 1 6 1 15 25 14 44 35 19 29 41 1 34 34 23 1 1 5 30 3 15 21 12 4 12 1 45 32 22 27 32 33 42 27 45 1 28 13 1 35 5 15
47 49 12 38 20 37 1 1 28 14 1 3 30 1 18 1 49 28 24 20 40 1 11 1 41 27 48 13 43 14 30 1 46 13 38 7 46 1 1 22 38 1 49 25 29 3 9 4 46 24 46 1 12 5 1 50 14 48 1 8 20 28 12 29 15 10 12 43 1 24 1 15 23 10 37 45 31 15 48 37 34 3 34 1 36 1 1 1 1 1 15 23 1
46 43 42 40 22 1 18 1 2 12 1 33 43 26 27 30 7 39 1 3 10 32 30 28 39 1 43 1 32 38 44 30 6 1 40 17 17 1 47 1 1 16 27 25 1 7 13 18 1 20 1 25 44 40 2 18 8 1 5 31 18 3 24 29 1 1 26 27 39 1 39 49 32 1 1 40 1 7 34 14 49 26 44 30 3 36 14 1 28 1 11 50 45
15 40 2 49 1 11 46 1 27 6 13 32 1 11 34 3 29 38 41 9 13 45 36 8 15 21 27 40 47 1 44 1 1 27 1 2 1 1 50 43 17 1 32 40 36 1 15 32 26 29 1 37 41 12 41 34 1 39 1 4 1 25 5 40 1 45 42 31 1 1 1 1 1 6 32 4 25 39 39 1 1 49 28 1 19 17 1 6 45 4 1 6 20
39 22 26 42 29 19 1 41 2 1 1 24 24 22 25 1 1 40 7 46 1 37 3 32 1 46 1 8 1 35 1 45 1 1 1 12 42 16 36 1 43 13 34 13 25 26 25 36 37 20 26 1 37 48 29 39 1 23 1 3 16 1 13 24 13 47 8 4 44 8 1 31 32 17 1 41 1 26 1 44 3 6 1 1 1 3 13 1 44 4 18 1 44
38 20 33 20 26 1 25 23 4 19 1 1 1 22 29 50 41 1 1 40 6 12 9 41 33 1 13 42 1 1 37 12 19 5 16 11 26 1 30 25 5 1 1 48 16 44 1 41 34 1 5 2 1 1 1 27 27 1 15 41 1 7 1 20 25 7 7 24 46 16 28 1 8 36 14 24 25 31 4 12 13 40 15 32 48 19 41 49 26 27 28 35 1
1 10 14 1 32 42 13 1 18 9 21 1 44 10 39 37 1 33 35 15 6 37 22 42 8 1 32 11 21 23 33 1 43 1 9 48 49 48 18 38 45 46 14 6 15 9 4 4 27 27 31 17 1 27 41 7 1 46 21 36 1 1 3 38 8 1 1 47 36 35 33 21 20 33 35 10 25 1 21 1 1 47 9 15 26 24 15 1 1 11 38 1 20
10 46 13 35 31 37 48 29 12 48 29 1 40 29 11 24 24 40 23 43 23 49 25 6 45 49 4 50 22 38 33 1 30 6 1 27 4 47 13 43 3 43 1 1 42 26 33 31 7 1 49 16 9 10 46 1 36 14 17 48 31 48 24 8 7 24 26 12 21 19 23 24 24 18 37 1 32 1 1 40 28 12 25 1 1 50 33 43 29 1 1 26 17
8 17 19 15 50 30 42 47 48 18 25 1 28 1 44 1 28 1 17 1 41 1 26 3 47 6 39 36 39 19 19 11 19 1 42 28 1 44 1 50 11 24 4 39 1 33 20 49 27 1 38 39 3 4 31 11 20 1 13 29 29 24 2 6 47 20 1 15 11 39 22 43 7 1 42 1 1 25 50 23 21 4 26 15 27 27 13 37 45 1 47 37 1
31 16 25 22 1 7 1 44 1 44 4 44 30 19 31 40 1 10 20 37 47 49 6 48 22 15 48 1 10 1 1 1 13 15 20 30 40 1 1 18 40 33 46 18 25 30 21 1 41 30 26 1 22 34 1 13 38 15 1 22 48 35 1 10 1 36 20 40 6 12 42 14 1 41 19 6 41 35 45 30 1 36 20 34 14 1 1 31 45 1 14 15 36
23 27 41 2 13 49 40 26 40 1 12 19 1 34 1 1 1 34 33 1 30 1 50 42 50 23 17 17 14 19 48 1 1 47 49 43 5 39 34 21 25 43 44 1 32 9 45 26 6 1 17 8 17 1 38 7 1 4 29 8 42 1 1 12 32 5 36 15 1 1 26 50 13 3 4 41 39 1 43 2 25 14 33 39 28 22 1 39 1 8 1 16 29
23 20 25 1 17 14 15 7 9 17 21 44 14 5 8 1 34 48 1 3 20 31 10 1 44 3 45 9 13 34 41 2 22 22 21 50 1 15 4 49 47 7 6 24 16 48 5 1 40 1 1 48 12 34 35 43 13 9 1 6 10 25 1 17 12 44 1 1 5 1 24 1 1 1 42 6 29 1 27 1 2 13 1 16 46 50 37 10 16 39 43 13 27
44 14 49 28 44 49 46 19 14 22 1 16 15 1 24 46 31 7 44 6 34 10 39 25 1 20 21 43 1 20 9 16 39 32 33 23 1 28 31 41 42 1 26 49 5 1 6 30 14 15 1 45 33 8 41 27 31 21 43 42 32 29 32 44 38 44 24 37 1 1 1 1 29 33 38 1 43 25 37 1 1 40 43 9 19 1 12 50 34 1 4 13 1
36 9 25 47 28 50 13 1 7 1 10 24 35 26 1 37 3 1 12 19 33 18 41 1 22 1 37 1 41 11 1 45 1 38 4 5 11 13 1 23 49 12 14 47 1 1 4 1 18 1 45 1 42 40 15 1 25 25 20 17 6 36 16 15 26 37 17 47 23 6 23 23 16 9 12 7 1 26 48 10 49 28 49 35 18 32 26 32 1 1 42 1 1
12 14 1 49 40 38 10 21 39 1 16 43 1 40 32 1 1 50 30 14 41 12 46 10 21 16 24 49 1 48 33 23 1 43 33 1 34 34 1 21 26 26 27 10 1 34 4 3 16 1 35 8 22 8 39 1 40 30 2 1 34 23 9 34 12 41 22 6 16 1 35 47 13 32 47 39 41 32 14 8 30 10 5 26 39 1 1 4 1 26 9 33 39
1 32 31 50 1 3 43 1 38 35 50 41 15 5 1 38 1 33 1 33 18 9 1 1 20 1 43 7 7 11 10 1 36 32 42 38 1 1 33 36 1 36 1 37 1 14 16 18 32 1 1 21 19 21 45 14 40 12 1 12 1 1 31 1 7 1 25 24 11 6 1 1 3 13 1 1 42 11 32 1 43 1 22 44 45 25 20 13 7 1 1 3 26
40 4 33 13 45 1 18 11 24 1 9 13 39 33 33 14 28 3 1 10 47 34 20 37 43 46 20 35 1 5 42 33 19 5 41 1 41 34 39 26 1 30 24 5 27 9 1 1 1 4 37 12 43 44 42 39 1 20 37 22 17 48 23 1 9 1 36 14 30 2 47 26 1 20 12 42 18 39 30 4 41 25 17 19 47 43 12 42 28 1 1 22 1
3 1 48 50 30 45 1 5 31 21 17 39 30 10 2 17 7 32 1 26 39 1 49 1 25 44 26 38 9 1 13 25 5 46 19 8 47 4 42 34 28 32 23 25 26 21 1 15 41 45 30 47 19 1 45 1 5 1 27 28 1 3 49 25 1 11 16 1 26 31 1 5 42 46 40 1 27 12 1 37 19 29 14 45 22 19 27 37 13 5 41 21 34
6 1 1 4 38 4 16 16 1 1 10 38 21 30 39 24 15 1 1 22 12 12 18 15 20 42 42 22 38 10 4 3 1 30 49 22 4 33 32 28 33 23 50 26 36 7 2 48 7 34 33 1 1 1 33 10 33 12 24 1 49 1 49 1 49 25 27 45 29 31 1 50 50 34 31 1 48 42 2 1 1 27 8 50 48 1 19 9 34 1 26 47 41
1 25 15 1 1 1 10 13 2 16 44 44 1 17 23 34 17 23 9 45 16 1 45 1 31 33 17 1 1 47 39 21 24 1 18 1 10 1 14 1 1 45 31 33 1 12 1 1 23 49 34 37 8 40 45 22 1 29 3 5 25 24 10 32 1 8 47 1 1 34 21 18 1 1 21 1 45 49 25 1 11 7 1 7 39 46 1 1 21 1 43 32 21
11 1 28 27 11 45 50 20 45 26 15 1 1 26 1 42 42 26 7 16 33 1 6 12 18 8 14 1 1 1 36 1 13 8 32 32 3 42 29 3 1 1 8 8 1 8 1 23 28 44 39 49 48 46 1 1 33 22 33 41 18 7 3 3 16 1 43 1 1 38 2 33 39 1 29 6 37 45 1 39 1 44 4 1 28 46 21 1 41 42 44 1 33
50 36 33 48 29 37 32 1 48 46 1 43 17 19 30 1 41 17 21 3 21 1 23 4 17 48 1 1 1 3 37 18 1 42 31 1 27 46 12 1 17 1 45 37 1 1 1 36 37 2 27 37 50 1 1 8 24 1 22 42 1 45 47 16 32 20 4 3 44 41 33 8 1 18 13 16 13 1 1 3 1 1 8 38 1 1 33 6 6 27 3 31 8
20 32 14 49 13 11 30 50 46 37 1 1 5 30 2 29 1 1 28 1 1 46 8 5 37 14 39 32 2 35 32 1 29 1 1 31 16 11 1 1 42 37 43 29 42 5 1 39 32 11 1 18 31 18 45 40 13 1 50 6 34 46 19 20 44 20 24 42 4 42 27 1 7 47 16 34 5 42 6 47 22 42 40 1 39 1 3 1 38 45 28 45 25
4 49 4 4 7 42 10 21 16 17 50 9 44 27 19 1 40 50 3 7 26 14 46 19 14 9 3 11 1 13 1 1 22 43 1 16 44 1 1 35 1 32 8 20 1 38 1 1 38 10 46 37 1 26 42 1 6 11 18 3 17 31 7 1 34 23 42 26 48 19 21 3 7 46 1 4 1 1 41 39 1 1 36 44 25 9 20 10 1 46 35 38 25
30 1 26 18 19 1 1 1 41 15 41 1 49 45 1 3 44 27 14 13 14 2 43 1 9 45 44 37 12 19 45 1 21 1 1 1 15 45 50 18 1 1 5 1 44 10 1 28 11 1 1 18 1 3 16 47 16 11 35 1 38 1 29 1 25 1 1 14 6 1 3 21 19 37 36 7 40 18 1 7 1 34 20 1 47 1 18 3 28 19 10 15 11
43 1 5 6 1 45 13 1 9 39 15 24 26 1 36 29 1 33 19 14 38 12 1 1 15 25 1 12 1 22 47 1 46 5 21 34 44 16 36 40 36 40 36 8 9 18 42 24 44 48 41 20 25 8 31 1 46 49 1 43 15 14 27 46 6 30 4 1 41 50 1 1 24 18 47 25 17 1 3 1 50 8 43 10 1 9 1 27 40 1 50 47 25
4 50 1 5 36 22 3 37 46 3 24 33 17 9 37 36 38 39 50 23 15 1 1 1 25 1 1 1 1 30 1 25 19 16 48 22 41 36 37 7 1 1 1 35 17 4 10 1 1 1 1 18 42 6 42 18 32 38 9 1 26 45 10 1 5 9 26 44 1 14 31 44 1 3 4 50 8 13 1 3 40 47 36 32 9 37 8 13 34 1 19 26 25
12 16 21 37 35 25 6 41 30 30 1 8 1 20 1 46 1 42 10 32 40 41 33 27 19 16 1 48 1 38 11 19 30 41 25 14 35 47 41 47 10 13 47 8 1 43 19 44 49 10 40 24 28 37 1 29 26 28 1 29 37 45 1 1 44 28 46 8 50 3 8 1 1 5 5 7 1 28 1 37 13 45 4 13 44 47 50 3 8 1 1 25 38
35 1 28 1 2 10 50 19 1 36 28 1 38 7 42 10 41 3 8 31 31 33 50 9 27 6 28 20 1 27 6 41 1 5 34 11 10 1 36 17 1 38 32 10 23 1 1 1 4 23 17 44 10 5 13 23 1 1 39 28 1 18 1 17 31 40 1 10 28 1 22 1 9 14 49 18 27 1 28 28 26 33 5 2 37 26 29 33 1 10 49 16 29
32 1 1 32 1 41 23 12 50 20 12 43 47 1 36 1 1 49 25 35 21 32 1 1 1 28 38 41 39 48 7 1 15 10 1 1 29 6 32 33 5 1 14 1 14 7 41 45 24 9 16 3 18 28 26 30 31 1 44 1 15 17 19 45 19 1 41 37 2 30 40 1 42 43 3 27 1 42 11 5 17 1 47 33 4 34 47 47 31 43 47 36 1
1 5 38 36 36 41 32 1 1 42 1 45 8 3 5 23 27 2 1 36 40 1 31 1 40 37 5 30 44 22 8 50 37 33 1 5 44 1 1 19 10 14 1 22 1 22 13 12 22 24 1 12 27 27 37 1 34 26 23 14 1 45 45 46 19 30 38 1 2 1 20 27 1 11 1 26 11 19 19 1 2 1 41 1 1 6 40 33 22 45 12 23 10
19 37 38 42 44 1 39 5 36 17 2 7 31 24 40 41 24 4 5 27 43 19 44 2 1 15 7 19 20 1 13 1 42 1 20 1 8 22 23 1 45 14 9 36 16 1 45 44 1 28 17 14 42 9 1 22 10 1 11 24 1 1 11 1 26 8 44 42 1 27 27 26 1 3 28 36 23 42 1 45 27 1 14 5 5 45 35 13 1 1 1 33 22
16 1 1 19 16 37 1 16 35 1 16 29 29 1 45 49 4 43 11 45 29 7 42 48 46 1 1 1 16 18 50 30 1 1 18 35 37 32 1 14 3 1 41 44 17 12 2 36 1 7 1 1 13 33 20 1 17 36 41 15 36 30 27 31 39 3 45 1 19 1 7 8 26 44 1 1 42 2 27 1 1 47 1 33 12 21 47 23 42 28 4 3 15
21 29 16 1 39 36 26 37 34 15 25 1 16 35 2 33 11 1 12 4 43 28 23 2 44 1 39 13 5 34 1 26 1 41 6 22 38 11 23 9 1 21 24 12 12 37 9 25 46 19 1 12 1 1 16 1 9 39 1 32 1 1 1 7 22 1 1 1 22 30 46 29 1 31 13 22 1 17 47 28 45 22 28 21 11 1 32 15 1 26 19 38 8
1 1 49 3 1 21 1 43 38 3 38 42 12 1 1 16 22 15 29 1 1 9 30 43 18 5 1 27 21 1 18 21 36 36 27 35 35 44 49 4 23 16 41 10 49 28 1 1 1 48 1 33 2 33 18 1 1 50 15 42 44 34 5 32 14 13 9 1 4 1 37 35 8 34 32 1 23 22 12 50 47 29 5 43 21 7 1 9 32 31 29 24 49
28 20 25 13 19 34 27 8 1 1 17 1 27 44 30 1 1 1 50 2 4 8 48 12 1 4 46 42 1 46 33 9 11 50 21 1 40 33 1 20 1 1 1 2 1 49 25 1 45 46 9 1 8 1 1 19 1 7 1 39 13 1 1 1 27 1 33 7 47 20 16 9 24 1 7 11 29 17 4 12 16 13 1 25 8 2 50 3 1 1 22 23 43
40 1 24 1 43 40 32 29 14 37 1 15 8 23 8 1 9 1 34 48 10 17 21 1 43 26 18 7 17 48 1 3 13 29 23 42 8 1 1 12 14 29 38 38 15 1 29 41 1 35 3 39 24 31 1 26 35 15 17 25 18 17 19 1 26 24 38 47 26 1 45 16 27 6 25 20 1 16 48 18 20 49 38 30 48 45 46 1 47 50 1 15 42
1 19 13 39 43 27 17 41 2 1 35 27 34 1 27 48 19 39 50 21 3 41 41 33 20 1 26 48 18 44 19 17 9 32 1 3 7 25 1 46 25 44 49 16 1 1 47 25 26 1 5 1 1 39 49 45 12 39 1 49 1 1 1 6 5 24 1 1 47 25 38 29 1 26 45 4 19 4 20 1 1 13 10 1 3 1 14 44 37 4 1 15 19
1 49 49 15 38 12 7 41 13 1 1 4 34 1 1 1 48 43 45 46 1 1 49 14 14 34 49 23 1 6 1 1 34 31 21 24 44 38 1 22 40 21 9 21 7 42 18 10 50 44 3 14 1 1 3 9 16 38 1 36 7 1 1 1 22 6 1 31 30 22 46 12 9 1 33 46 1 29 39 21 7 1 30 17 12 36 21 15 46 1 1 31 44
43 47 14 36 13 42 22 1 35 4 1 25 1 12 40 1 46 1 18 49 18 29 18 1 2 1 15 24 45 27 1 1 18 1 1 7 43 1 8 28 37 25 49 22 9 1 24 34 22 23 5 14 1 1 41 37 29 2 24 21 47 49 7 12 8 12 4 10 18 45 1 33 44 48 21 9 1 21 43 43 19 48 2 10 1 42 1 17 1 44 11 25 1
45 1 25 1 10 40 23 17 14 40 1 19 45 1 1 9 46 14 6 3 2 45 37 1 36 44 36 21 43 46 25 48 25 1 47 44 41 11 1 13 49 25 32 4 1 1 11 1 11 49 1 9 12 1 44 1 9 39 1 37 31 4 19 39 5 21 21 29 30 11 1 43 19 42 1 5 45 11 38 44 1 28 35 12 19 8 27 8 10 42 33 26 16
2 5 12 1 49 25 3 31 23 1 1 35 6 1 35 1 17 25 20 1 41 21 39 1 43 26 1 1 48 5 3 1 37 44 1 4 34 41 37 1 18 7 1 30 22 35 1 38 12 20 45 35 40 15 44 12 1 24 26 8 10 1 6 38 20 15 8 45 22 1 9 27 1 21 1 15 27 7 46 1 14 42 45 1 10 36 47 41 35 1 1 1 1
7 1 1 44 1 5 2 25 6 4 35 4 1 32 16 50 27 27 37 20 35 1 1 19 15 2 1 44 38 1 32 12 1 1 9 1 46 34 43 1 41 17 1 25 25 30 42 10 34 18 23 12 5 16 9 5 5 22 39 28 12 32 22 20 11 41 32 3 19 1 1 35 15 15 1 15 50 7 47 46 5 13 14 1 1 1 5 1 33 1 23 29 42
22 47 1 13 15 49 1 46 16 50 27 39 3 47 1 32 1 48 1 13 32 14 1 38 7 16 37 24 1 25 1 21 1 46 4 4 43 1 40 18 35 1 5 1 36 44 11 38 27 9 5 1 28 41 38 22 30 9 8 1 1 1 3 6 1 48 3 16 9 1 24 48 12 23 1 42 18 41 37 1 1 21 31 26 1 33 16 46 28 22 1 1 23
12 21 1 1 1 31 1 41 50 14 23 31 31 38 11 1 20 47 1 14 2 11 22 1 43 46 21 9 39 1 29 13 43 31 20 32 1 30 12 1 46 1 25 24 14 46 1 1 49 3 1 1 25 19 49 1 30 27 8 6 1 48 27 17 30 1 8 39 43 44 13 15 1 39 24 33 1 16 1 21 42 3 46 29 1 15 23 1 21 20 39 15 1
1 39 1 15 9 27 49 27 43 6 8 36 31 29 33 19 37 1 47 5 21 22 21 15 25 23 7 15 9 1 34 31 24 1 46 15 16 50 23 1 40 26 21 19 6 24 1 29 1 1 41 45 43 17 11 34 23 1 2 48 44 36 17 1 40 41 23 1 18 43 25 1 7 39 16 27 13 28 32 6 50 41 8 12 37 15 1 45 1 36 8 33 11
7 8 44 50 1 2 20 14 1 46 7 45 36 14 6 13 14 29 29 1 33 49 30 42 1 3 7 1 39 47 30 46 49 1 23 15 2 31 20 14 23 1 34 1 1 47 21 1 24 19 44 7 4 12 27 4 49 1 38 12 6 37 34 1 35 24 12 38 2 43 47 25 1 13 1 1 1 1 30 32 16 46 44 1 1 17 24 21 10 27 13 10 28
46 7 45 26 18 48 14 17 1 22 1 1 50 30 35 38 9 24 39 25 26 27 6 18 1 21 23 1 37 1 32 43 24 8 46 28 1 16 40 1 1 16 1 17 1 18 15 32 1 45 19 5 1 15 1 16 32 9 13 38 1 49 16 10 1 8 43 48 19 3 9 23 9 37 34 22 1 1 44 22 46 24 20 35 1 1 31 47 14 50 1 1 13
2 27 37 31 12 19 17 1 8 24 11 31 21 20 27 29 45 35 3 41 4 4 1 27 47 12 18 23 44 3 36 4 49 16 26 1 42 25 1 3 46 1 1 46 34 1 9 1 10 49 38 17 43 33 15 2 49 20 28 5 25 1 1 12 35 1 43 10 1 15 1 1 1 1 4 33 21 40 1 1 1 35 12 16 32 27 49 1 1 1 9 39 25
45 1 41 1 27 37 35 7 30 34 26 25 10 4 44 34 3 1 25 49 41 50 13 2 1 1 7 42 1 50 11 26 25 1 1 1 45 30 1 13 1 15 13 31 41 12 47 18 44 33 36 1 16 2 1 1 39 26 8 26 41 40 14 13 6 1 12 29 23 28 26 46 41 47 8 32 14 36 36 1 1 41 1 1 44 12 30 3 29 36 25 17 1
6 30 23 1 2 39 35 1 41 37 49 18 1 12 11 20 1 1 17 12 32 33 29 1 33 25 41 1 7 26 1 11 1 38 7 42 1 41 41 32 43 1 38 5 17 19 1 42 47 37 1 4 4 40 35 27 11 46 31 1 41 47 7 29 1 18 6 48 13 25 1 35 29 2 40 1 1 15 29 5 42 41 27 1 1 1 31 19 41 25 39 41 25
28 1 12 1 40 42 2 34 19 40 10 30 33 31 27 2 5 8 1 6 37 1 26 17 31 47 50 1 43 1 1 32 4 32 9 19 26 17 25 8 14 8 1 12 15 1 21 23 46 37 5 14 1 20 5 1 11 50 35 26 35 1 1 31 33 2 27 1 21 1 47 5 22 4 35 28 37 3 1 21 48 3 36 1 40 43 12 20 1 44 1 3 22
25 17 1 31 1 13 1 18 44 34 33 38 12 42 36 23 44 42 28 45 28 21 6 1 33 50 23 48 2 1 6 28 5 27 31 1 5 33 6 9 39 35 6 20 19 1 7 48 45 34 28 18 1 5 11 23 31 4 13 23 1 44 44 27 3 44 46 41 5 41 1 29 42 4 33 3 1 1 18 4 32 47 1 4 24 6 39 35 45 18 13 33 1
18 19 1 14 41 41 2 1 7 49 44 30 1 1 1 7 9 10 1 1 27 14 47 6 16 17 49 1 39 42 37 38 36 32 1 15 16 30 37 49 8 16 39 47 7 16 50 1 1 27 47 16 44 1 7 1 1 36 43 37 3 16 45 1 29 1 15 1 24 19 1 1 28 1 25 12 40 15 1 16 48 35 1 15 14 21 1 9 46 7 49 24 17
1 1 39 12 33 1 32 31 45 10 41 1 33 1 15 22 48 1 33 5 36 50 1 1 2 1 34 46 1 48 4 1 15 1 4 4 1 21 17 37 43 1 25 18 34 3 40 48 15 45 46 42 28 1 36 9 42 16 43 19 1 6 38 21 1 32 36 8 1 25 32 1 1 50 32 40 11 1 1 23 34 34 45 32 21 1 5 1 1 13 1 7 37
14 1 36 42 1 2 46 1 31 17 39 15 47 1 18 1 7 19 44 40 1 8 1 9 20 41 16 17 16 22 32 47 20 32 1 1 20 1 17 3 1 1 14 17 1 8 28 25 2 29 45 28 35 50 24 50 27 10 11 11 1 26 37 36 44 2 3 38 18 28 1 50 16 1 35 1 16 1 23 19 35 41 1 31 36 35 43 15 48 50 32 23 2
1 40 1 43 33 18 24 12 20 1 46 47 31 31 1 45 1 26 6 1 46 1 17 29 13 46 27 7 11 3 41 1 25 8 33 1 3 4 41 1 47 36 32 1 2 19 40 28 12 31 1 1 1 1 33 16 1 1 23 28 18 34 15 3 30 34 3 1 24 14 26 1 24 38 29 48 1 1 37 33 41 36 18 45 1 9 38 1 9 24 1 26 1
48 28 25 45 1 1 9 1 11 34 15 20 10 1 7 40 1 1 1 27 16 20 40 23 40 27 3 46 10 31 31 46 39 12 37 12 13 18 50 1 32 1 17 27 32 1 38 47 48 44 1 4 15 1 1 26 11 20 42 44 18 14 1 17 29 22 1 34 10 3 1 33 7 22 6 1 37 5 17 21 36 1 1 9 48 1 45 17 1 17 14 43 45
30 1 21 1 6 1 31 1 1 3 19 26 43 18 46 1 25 34 25 11 36 2 34 49 1 33 1 27 35 1 49 1 1 1 39 50 49 19 20 26 23 10 23 1 10 46 7 32 20 35 23 8 38 9 34 29 33 1 1 1 1 1 1 5 28 41 11 1 12 41 28 49 35 1 48 34 1 24 27 8 29 45 1 1 1 1 6 47 20 1 1 16 43
1 20 14 6 1 18 8 48 24 44 32 32 42 39 22 1 50 26 45 1 1 14 7 11 25 15 42 1 4 34 2 1 40 1 29 1 49 35 1 46 29 22 43 5 1 9 24 6 1 1 1 1 1 19 1 26 18 1 1 39 31 21 9 49 4 41 1 32 11 1 26 1 1 17 38 21 49 42 46 18 50 1 18 44 1 33 18 9 1 42 26 34 8
49 1 29 9 46 1 49 50 44 37 1 1 31 1 21 26 31 4 31 16 45 9 6 30 47 1 1 1 38 20 4 42 24 29 42 2 1 28 1 17 1 12 38 49 35 1 7 19 5 49 5 14 1 23 48 41 7 29 1 2 26 14 3 33 36 49 49 27 1 26 11 1 1 23 1 6 3 1 9 10 46 37 20 10 41 35 9 49 18 40 30 18 31
40 38 14 18 31 36 9 1 17 45 25 43 5 30 19 27 2 32 6 43 7 26 18 49 28 38 11 10 18 12 24 30 1 1 6 9 14 35 27 5 35 10 8 1 5 1 8 24 46 7 7 41 1 50 35 21 13 16 20 1 14 25 1 1 2 40 7 1 12 16 1 13 31 10 44 33 21 38 30 41 29 1 1 1 3 1 41 42 5 15 27 40 1
49 38 1 16 36 19 32 32 48 35 9 44 23 1 44 1 4 20 20 30 42 42 36 14 30 13 16 36 1 1 44 12 46 34 36 21 25 1 30 28 50 42 33 42 28 20 45 2 1 23 38 38 4 41 6 41 1 38 1 31 1 27 36 27 43 43 14 8 25 46 36 6 16 1 6 49 1 40 22 9 21 32 14 1 47 41 10 20 41 1 7 50 37
31 1 20 17 14 1 26 12 17 19 8 39 12 18 20 6 29 1 38 1 17 1 21 40 4 47 16 45 33 48 12 25 34 22 33 22 31 26 1 6 37 17 1 1 6 46 12 17 47 49 3 23 1 22 38 20 15 7 1 5 12 21 47 26 41 39 1 1 21 17 48 1 1 24 5 35 30 1 43 29 3 48 17 46 1 23 1 32 15 14 33 40 1
42 7 21 19 1 9 1 41 8 19 25 47 26 15 1 29 33 1 41 1 10 1 33 11 11 30 2 44 30 44 20 18 1 12 3 14 1 26 4 30 1 46 23 21 37 38 1 41 1 3 16 11 19 33 4 19 26 28 22 8 27 2 1 46 7 48 20 1 1 24 1 3 1 6 8 44 21 17 5 1 1 30 2 2 27 39 12 35 1 12 4 47 46
20 50 21 16 49 22 32 7 40 1 1 37 44 1 26 49 5 26 17 29 1 15 16 5 1 1 8 5 39 24 12 1 1 40 45 44 1 46 3 47 30 11 10 38 9 1 35 30 31 26 13 10 15 16 46 5 43 4 48 44 34 10 1 29 49 3 1 33 38 3 9 45 9 1 1 9 31 11 35 17 45 17 1 29 1 27 32 25 25 43 6 50 1
24 34 39 44 43 38 35 1 36 22 1 40 8 41 29 10 1 29 10 23 41 1 6 10 1 49 30 1 3 1 13 46 25 34 1 7 50 40 16 1 18 4 1 1 1 30 2 12 31 48 26 42 39 38 11 41 40 10 34 8 23 18 23 42 24 18 1 11 21 42 41 13 43 19 26 16 20 43 42 1 31 47 10 1 28 1 34 37 30 1 34 1 1
44 23 1 23 32 14 22 46 40 6 37 43 23 26 42 22 31 1 41 40 30 6 29 25 4 23 24 7 24 41 2 25 25 27 22 1 15 3 6 1 1 44 16 35 1 27 7 26 30 4 1 17 4 20 17 45 15 1 1 10 1 1 14 31 46 31 9 1 17 50 6 5 44 7 28 31 4 10 32 1 1 8 1 31 21 50 34 43 44 9 1 31 42
6 39 8 47 1 36 26 36 41 22 2 2 22 1 15 1 1 1 35 44 43 1 34 40 6 1 9 47 31 39 37 1 29 41 2 5 1 25 1 1 45 49 45 1 1 1 1 46 45 22 9 48 37 12 1 22 3 1 34 28 1 43 16 8 26 42 35 38 1 49 27 22 8 43 16 5 1 48 19 19 15 40 48 29 46 1 43 26 18 23 1 20 39
