20
10 6 15 11
49 40 1 49 7 15 1 1 11 4 35 29 17 37 3 1 48 37 5 28
40 46 1 33 47 6 48 46 1 17 44 6 14 42 18 22 30 9 17 28
8 1 29 31 1 42 11 6 19 37 21 1 46 12 4 20 1 1 3 13
6 19 1 1 4 9 1 14 29 28 7 31 39 17 28 19 1 16 28 47
20 36 43 8 1 1 31 3 40 6 1 44 46 45 37 21 31 1 1 12
18 1 7 1 1 1 8 1 40 37 47 48 6 34 22 5 1 1 42 35
12 23 33 23 16 31 40 1 1 40 34 17 44 21 12 38 1 19 13 13
28 8 17 49 2 1 2 44 22 1 21 7 1 34 5 30 1 39 50 6
1 1 33 50 15 1 20 14 43 14 1 1 18 1 3 25 1 10 29 39
1 43 34 6 44 20 2 15 43 18 33 44 31 6 1 48 44 29 4 41
1 1 1 38 1 1 31 5 1 2 44 4 27 1 1 26 1 1 48 12
49 49 9 43 35 5 43 1 35 39 47 32 2 1 24 12 10 44 30 7
1 39 23 29 42 28 39 2 24 43 9 4 47 1 50 37 32 49 1 33
1 1 33 2 23 1 36 1 25 42 49 29 1 18 19 47 1 24 6 33
44 1 20 36 40 13 1 29 29 17 1 30 34 46 4 40 36 33 9 35
1 14 36 35 14 18 19 1 48 10 43 1 18 33 1 38 47 12 21 1
17 1 1 20 1 40 9 1 29 3 43 34 26 5 5 46 42 25 17 1
47 31 49 22 49 50 1 8 1 20 1 23 1 23 33 48 9 25 23 47
26 43 1 1 1 1 26 1 18 25 3 25 27 15 38 1 1 27 14 1
4 46 40 20 12 31 1 16 50 30 1 20 17 11 17 49 28 50 1 1
