99
45 26 53 80
18 9 16 14 6 15 14 18 1 17 11 17 11 15 19 15 19 1 5 1 9 10 7 17 19 5 7 14 11 14 17 20 9 5 20 10 12 15 15 14 12 13 6 15 14 1 13 14 1 5 1 16 8 14 20 5 17 19 19 16 5 15 6 9 18 5 9 10 20 10 16 9 8 1 18 8 11 1 16 11 10 20 13 18 10 9 14 10 17 10 15 19 13 19 1 18 7 9 19
10 12 14 7 13 15 1 16 16 6 10 6 1 5 7 9 9 12 7 15 14 17 9 9 5 1 18 11 10 11 19 15 16 1 1 6 9 13 17 20 20 1 5 10 17 1 7 19 1 6 16 7 13 5 11 19 8 7 6 18 5 13 6 6 15 15 11 10 18 1 20 1 6 7 7 18 15 7 12 17 10 1 16 6 6 14 6 17 8 12 18 14 7 6 9 12 14 20 20
10 16 18 7 12 11 6 10 8 13 15 15 8 13 20 19 16 10 7 17 9 1 12 7 11 11 11 16 8 1 16 5 11 15 7 16 12 17 9 11 10 1 1 1 10 16 14 11 1 5 20 5 14 15 6 20 6 13 20 12 8 16 8 13 1 14 14 14 1 17 19 17 12 20 17 1 15 17 8 8 14 13 1 6 20 9 16 1 18 11 16 14 10 7 15 18 18 13 19
18 17 6 15 17 8 1 18 7 11 15 14 8 11 10 11 12 19 10 18 18 12 20 17 13 11 5 7 15 12 18 12 11 9 9 6 18 6 18 15 10 11 15 12 6 8 11 1 12 13 17 7 9 16 1 13 10 13 18 11 13 8 14 11 7 1 16 14 8 7 15 18 16 1 5 13 7 12 1 15 11 8 15 19 11 1 13 10 5 19 13 1 1 16 7 20 7 20 9
7 13 13 17 16 10 20 12 10 1 8 20 1 18 7 14 11 10 11 1 15 17 1 20 13 14 12 7 1 9 10 15 18 7 18 15 14 18 18 9 9 11 18 10 14 18 1 19 10 1 15 6 13 17 7 8 18 18 6 15 13 6 5 10 6 1 17 12 5 19 10 13 8 1 5 17 1 19 5 6 19 9 10 9 7 13 20 16 10 1 5 7 19 18 16 1 10 11 13
12 6 13 8 17 18 11 20 5 16 18 9 8 17 12 11 20 14 1 13 1 9 17 18 10 18 17 17 16 15 11 8 8 9 6 9 9 7 7 16 19 18 19 7 7 9 12 9 11 15 14 13 13 14 14 1 16 18 18 8 1 11 20 9 20 18 18 1 7 6 1 12 6 12 5 1 20 16 9 8 12 1 18 11 8 9 20 15 10 10 18 1 5 5 13 13 8 19 1
5 15 1 8 13 1 7 9 7 10 6 20 14 11 17 8 18 5 11 14 7 7 9 16 5 17 15 14 11 16 9 10 8 1 19 16 5 6 7 6 7 9 17 10 12 9 5 17 14 9 5 5 14 19 12 1 8 9 1 9 1 5 10 12 20 14 5 18 5 19 13 17 1 7 13 1 16 5 17 11 1 10 11 17 5 10 19 7 1 11 8 15 5 9 5 7 15 6 18
16 10 19 10 14 6 15 8 13 17 15 14 7 11 12 10 9 9 18 13 10 8 1 13 20 14 17 6 17 9 15 1 6 6 12 14 17 1 13 8 12 12 17 15 18 13 1 10 15 13 20 6 15 16 7 15 5 20 6 17 19 19 8 5 19 6 8 1 11 20 8 19 17 9 10 8 7 1 11 17 18 6 5 8 15 13 12 12 12 1 11 12 14 10 16 16 1 11 17
17 13 20 13 15 7 8 12 15 15 12 12 10 1 11 11 10 17 17 20 1 5 7 20 10 11 11 8 12 5 7 7 1 9 6 13 15 1 12 19 7 18 19 18 19 18 14 14 5 5 19 18 1 12 17 15 16 9 7 6 14 5 1 11 18 15 8 19 6 13 14 9 10 9 15 12 18 16 14 5 1 1 15 17 5 8 14 10 14 19 8 12 9 10 13 17 19 14 9
5 9 15 9 7 1 14 5 19 12 17 7 8 5 9 17 11 6 19 1 9 9 20 11 16 13 8 19 7 17 6 9 10 1 8 15 19 14 10 18 1 1 10 6 12 9 19 7 9 13 1 19 5 14 20 9 20 16 7 17 15 1 12 5 19 14 7 5 15 8 8 10 14 6 1 18 6 1 18 16 16 18 15 10 17 7 16 16 16 14 1 6 1 20 9 11 5 18 5
9 13 16 6 18 1 16 18 8 1 7 18 9 1 10 14 5 9 1 14 20 14 17 17 6 12 8 1 7 14 8 20 7 20 1 13 1 16 17 11 19 13 12 17 6 1 6 9 5 10 7 17 18 16 19 11 6 11 17 14 17 14 18 7 9 1 15 14 6 19 19 7 1 6 19 6 14 8 1 17 8 13 6 5 15 20 19 15 20 5 20 20 13 7 19 7 16 9 12
8 13 8 5 17 9 10 20 13 12 9 17 6 15 18 15 15 12 5 9 1 8 11 1 1 16 10 17 6 15 8 15 10 6 14 1 20 1 15 8 9 1 10 8 18 16 20 20 13 10 16 13 6 18 19 13 13 1 5 16 20 9 1 13 19 15 18 12 8 1 18 1 14 5 5 8 7 8 15 19 14 16 15 10 12 15 9 12 10 13 19 18 12 12 18 19 5 14 5
18 1 5 17 18 8 20 12 20 15 10 13 6 18 12 17 12 1 12 8 20 10 6 10 5 20 14 19 10 6 6 8 7 15 14 1 1 18 20 7 8 7 1 1 8 7 12 20 15 7 5 1 16 14 11 10 7 7 16 14 11 15 16 18 1 10 12 8 15 5 16 15 20 14 5 1 13 14 7 18 17 13 18 13 1 10 20 15 18 6 1 14 8 11 17 1 1 10 5
12 13 18 9 1 19 8 18 10 14 9 19 12 18 19 12 10 7 6 5 16 14 9 6 9 10 6 19 9 1 16 20 7 18 20 15 6 7 18 20 19 1 8 5 9 17 19 14 6 14 18 1 17 11 19 17 17 1 8 18 1 6 8 9 17 20 10 1 18 1 13 10 15 7 20 13 12 7 1 16 1 8 19 7 11 19 17 9 1 13 20 16 7 9 16 15 15 18 1
1 6 12 6 11 1 20 5 15 13 9 15 10 12 13 15 14 14 14 1 20 14 18 1 16 18 19 11 18 1 11 14 8 18 9 18 6 7 5 6 16 7 16 1 15 1 6 15 5 11 6 20 10 1 16 16 9 14 19 14 17 7 17 20 17 16 12 12 18 20 6 8 9 1 16 1 20 7 7 18 6 9 20 13 1 1 1 14 6 6 5 16 8 10 8 19 13 17 12
20 6 15 17 17 9 9 20 5 13 17 16 20 17 12 16 1 14 7 12 19 8 12 17 14 11 1 19 11 10 20 17 20 18 14 14 7 15 6 9 5 19 9 1 1 18 12 15 14 10 5 17 1 1 7 5 7 19 6 1 18 1 6 1 15 1 17 20 1 11 8 15 7 9 7 17 10 11 12 1 1 8 16 13 17 6 19 5 11 13 5 14 9 8 1 12 12 9 13
18 12 8 1 16 20 19 10 18 8 17 20 15 6 19 10 11 10 15 14 17 1 19 11 6 15 15 17 17 17 9 6 18 1 11 17 19 1 6 1 20 8 5 18 17 1 11 10 5 17 11 19 14 7 15 11 6 20 9 9 20 19 16 11 18 12 5 17 6 9 10 17 12 1 8 9 10 13 9 10 10 8 1 11 1 19 6 10 8 12 15 8 1 20 8 12 5 11 18
17 1 10 1 14 20 1 18 11 18 10 10 6 1 1 11 11 1 8 14 13 13 16 5 14 5 14 14 14 17 17 20 1 16 5 15 16 6 17 15 6 19 20 12 19 10 11 13 1 5 19 15 1 1 18 5 1 6 16 18 5 1 6 5 11 6 20 19 7 5 20 12 15 13 5 5 9 20 16 19 11 16 17 8 18 10 20 11 13 6 7 19 7 12 17 12 13 14 8
17 11 18 11 10 1 1 15 9 1 7 6 18 12 19 20 19 11 1 13 5 16 17 19 1 12 19 13 10 10 13 16 14 6 9 14 15 7 19 16 8 1 18 15 19 15 18 20 13 10 13 10 15 15 11 17 1 18 19 11 1 1 6 10 14 18 11 17 12 19 10 12 6 5 5 12 19 15 10 19 14 9 15 8 9 9 17 20 17 10 20 19 1 13 14 6 14 5 15
20 20 6 14 12 20 10 1 11 8 12 13 14 6 1 15 9 9 9 17 11 5 13 6 12 15 17 13 19 15 6 8 6 6 16 11 16 16 14 10 19 6 5 16 20 19 15 6 18 14 14 18 15 13 17 18 13 12 11 6 6 10 6 8 17 10 9 14 1 20 18 5 11 14 7 5 15 14 17 1 19 19 16 5 12 8 11 13 6 1 7 11 14 20 18 18 18 1 15
5 1 1 15 16 6 9 20 16 13 6 14 5 13 19 19 16 5 5 6 12 9 1 6 1 7 18 17 7 7 12 1 14 1 8 20 12 5 1 11 8 19 9 8 20 5 16 1 12 12 11 5 20 18 8 7 12 5 18 10 12 18 18 6 1 17 1 7 19 9 1 6 18 5 12 19 17 1 13 15 10 14 11 5 7 12 1 9 17 1 5 17 14 20 12 20 18 17 1
1 1 1 7 9 17 15 8 15 1 14 12 9 17 5 5 11 10 16 7 6 11 1 15 1 19 12 11 14 6 13 8 1 10 13 1 1 7 15 13 18 14 16 1 20 5 11 1 12 13 15 16 1 9 18 12 7 19 17 14 20 19 18 6 7 18 8 11 19 15 15 16 17 8 1 18 14 5 7 18 1 14 7 19 1 1 18 8 11 8 14 11 6 6 17 6 5 9 19
5 14 9 5 15 20 9 17 7 6 20 14 6 17 6 7 12 5 7 11 9 6 1 1 11 19 16 11 10 14 6 5 13 14 14 8 19 17 15 7 9 19 15 1 1 14 19 18 7 11 17 6 18 5 15 5 1 12 20 9 5 20 19 1 9 16 6 8 11 6 5 7 13 14 17 14 8 10 9 5 12 5 8 8 13 9 17 19 16 1 12 1 19 1 9 14 17 14 5
19 15 17 13 1 12 11 1 11 15 18 19 19 8 8 14 13 10 9 19 6 17 14 18 14 6 17 17 1 6 17 1 18 20 19 20 16 14 18 6 12 12 6 17 5 20 10 19 10 15 7 11 1 11 5 5 9 5 13 14 6 1 16 18 7 16 13 1 9 12 17 15 20 8 13 1 13 1 13 19 9 19 18 8 17 15 13 10 9 9 20 1 6 14 6 1 14 7 11
13 8 14 16 8 8 11 20 1 11 16 11 14 10 9 12 16 10 1 6 7 16 8 14 19 15 8 16 12 14 11 18 13 8 9 11 13 1 6 1 13 11 8 17 6 5 12 15 7 5 7 5 20 8 18 11 8 15 8 12 1 14 7 1 7 10 11 1 1 10 11 11 17 7 5 20 7 1 7 12 10 10 5 12 12 10 6 5 9 8 8 8 13 18 15 7 18 19 16
12 5 8 10 7 13 14 14 6 14 7 7 1 5 13 15 1 16 7 13 6 20 13 20 17 15 1 5 17 1 19 15 7 6 1 1 5 6 1 14 8 11 10 7 5 9 15 8 20 18 16 9 6 20 1 13 5 12 6 6 20 17 16 5 6 19 20 18 11 1 17 5 18 8 17 11 6 18 1 15 6 20 9 9 16 18 19 16 17 9 20 17 14 19 10 19 17 20 10
16 10 7 6 9 20 1 19 7 1 9 14 9 15 10 6 7 12 5 17 19 11 1 20 15 6 7 8 9 17 5 20 11 11 19 1 5 11 5 1 6 7 1 16 11 7 10 15 16 14 1 1 8 17 5 7 6 11 5 9 1 1 12 6 10 1 12 19 8 10 19 12 18 1 15 1 10 13 20 7 7 11 9 20 12 1 15 1 8 7 1 11 10 9 13 13 15 14 18
15 12 14 13 12 7 14 9 8 17 5 13 17 17 13 10 11 17 8 17 12 5 8 7 13 15 19 9 9 16 12 17 7 15 1 8 19 20 10 15 1 5 6 6 16 12 14 9 1 17 1 19 10 18 10 7 14 19 1 7 15 13 9 12 15 15 16 19 14 10 7 11 13 17 14 11 12 1 19 20 6 1 10 14 11 7 18 10 12 10 9 9 1 6 16 7 7 7 20
9 13 9 18 8 5 8 1 6 11 10 1 1 20 13 8 17 8 6 15 16 5 13 18 9 17 15 1 20 6 8 7 19 9 7 15 16 7 6 1 8 20 18 9 9 18 1 9 1 13 7 9 19 15 9 1 14 9 14 8 9 14 8 18 8 9 16 13 1 17 1 6 5 10 5 1 8 11 5 6 13 13 1 5 17 14 14 19 20 5 16 18 14 18 16 6 14 16 6
11 5 9 14 12 17 19 7 6 14 17 20 7 17 17 10 7 1 13 20 19 8 14 18 19 16 15 6 19 7 18 8 18 12 13 1 16 9 11 8 19 13 17 18 10 20 10 7 13 13 10 13 5 20 1 5 9 11 12 6 8 13 17 11 15 17 5 7 18 8 11 16 10 13 10 6 10 1 6 11 1 7 14 1 8 17 1 15 1 11 11 19 17 17 14 1 10 18 15
16 19 14 6 20 11 13 5 17 9 19 18 17 17 1 5 13 7 11 9 15 1 6 13 1 12 18 9 10 1 9 10 17 18 9 18 5 9 1 16 20 13 18 14 13 8 1 20 15 11 9 20 10 20 1 15 19 8 13 20 1 5 1 7 19 15 16 20 8 16 1 13 10 9 17 1 16 13 16 7 12 5 9 13 16 5 9 13 20 6 7 11 19 1 10 12 13 13 5
5 16 14 11 19 18 20 8 15 19 19 7 13 8 18 14 16 7 1 8 1 15 8 16 9 6 5 9 1 1 14 9 1 17 5 18 9 10 20 7 16 6 11 11 10 17 5 6 11 7 6 9 1 13 19 7 13 1 8 15 19 11 15 6 11 20 14 12 6 6 1 8 1 5 9 18 7 17 12 1 20 11 11 18 9 1 19 11 19 11 5 20 11 1 1 19 17 18 5
7 14 19 9 9 13 1 5 14 1 10 5 12 9 15 11 8 5 16 8 10 6 15 18 17 13 17 1 1 5 11 8 10 16 1 17 10 13 5 19 9 7 18 13 1 6 5 6 19 18 8 12 8 17 13 13 5 20 5 20 1 17 9 10 15 12 20 11 13 5 19 20 10 15 11 13 11 7 6 19 18 13 1 1 10 11 10 8 8 5 5 1 1 1 11 9 16 18 8
6 1 11 5 14 16 20 18 17 8 15 14 15 19 19 13 18 15 14 1 20 12 12 1 1 11 15 9 18 13 15 13 18 15 20 16 13 1 18 16 8 5 10 1 14 13 1 11 15 11 12 11 10 13 14 1 12 15 11 11 10 8 12 7 11 13 8 16 17 12 19 11 12 1 11 14 14 16 9 1 20 12 10 13 9 20 12 12 8 8 18 6 6 15 15 6 8 13 1
8 20 11 11 11 14 14 17 8 15 13 16 12 20 11 19 16 6 10 8 1 5 15 19 15 11 6 20 11 20 20 6 19 13 13 9 10 6 16 7 14 13 20 7 5 6 10 1 1 10 18 15 11 10 20 1 7 5 11 18 9 12 15 19 13 11 9 1 12 11 8 14 17 15 15 8 10 12 6 6 11 12 18 15 15 10 1 1 12 13 9 5 7 12 8 5 7 17 12
1 8 8 20 9 1 11 1 20 1 7 10 1 15 9 5 8 6 16 19 5 18 15 7 1 8 13 14 18 17 18 7 15 12 12 20 17 16 12 18 20 8 13 16 1 9 12 14 16 1 14 17 9 20 15 12 15 9 10 6 11 7 13 15 20 12 1 6 20 1 7 10 1 13 6 6 1 11 20 17 11 8 13 1 9 18 15 8 10 12 7 12 18 16 13 10 18 11 15
14 14 1 1 6 8 20 5 9 9 1 15 14 1 6 12 7 1 18 16 9 15 1 19 12 12 16 15 9 19 9 14 20 19 18 18 15 18 17 7 7 5 17 17 13 13 13 5 9 8 6 12 16 14 1 14 13 7 10 17 7 5 13 6 12 16 16 18 13 18 13 17 15 1 18 18 11 9 19 7 8 10 6 6 7 13 14 6 15 16 8 10 8 13 20 14 10 8 19
13 13 8 17 11 1 15 1 13 13 17 15 10 20 13 16 1 13 7 19 1 13 5 20 18 20 10 19 12 16 13 1 20 15 8 12 15 16 9 1 8 11 11 12 1 8 7 5 15 18 11 16 14 12 11 12 1 5 12 18 9 10 17 5 17 1 17 14 9 8 13 19 10 16 16 15 6 1 10 6 7 15 1 9 14 19 1 6 16 10 1 5 11 12 19 20 14 12 7
9 1 7 14 11 11 16 12 6 12 8 8 5 1 19 6 1 14 11 15 7 11 19 1 6 11 12 1 13 8 9 1 18 7 12 15 11 16 18 8 14 1 13 8 19 16 10 14 8 13 5 17 12 19 7 6 19 7 13 15 6 14 14 6 6 14 9 13 8 12 7 20 6 14 8 10 18 20 17 5 1 8 7 6 20 11 1 18 20 11 5 20 16 1 18 8 8 11 8
10 6 10 15 12 12 5 1 1 17 5 12 6 7 9 11 13 5 20 1 7 15 8 8 7 10 6 5 5 16 5 18 5 20 13 13 5 6 11 17 5 18 20 14 12 12 14 19 1 20 16 11 6 13 19 1 8 13 10 9 10 16 1 18 18 15 1 17 17 5 10 19 8 11 11 20 18 1 10 19 18 10 7 5 14 18 1 15 13 12 13 15 20 8 20 19 10 7 6
12 19 5 17 13 1 15 18 20 16 15 18 10 8 15 16 15 19 10 1 1 15 11 7 13 17 15 5 13 18 1 1 14 11 18 20 1 7 14 5 7 19 9 12 17 1 1 8 6 11 7 5 8 15 14 16 20 6 7 20 8 7 16 17 6 14 6 20 5 15 11 18 18 15 14 17 19 17 15 5 1 18 1 5 9 12 5 9 19 5 18 7 8 17 14 12 14 20 1
14 1 7 13 7 14 18 6 18 1 15 7 7 19 8 8 1 18 1 10 5 18 20 11 16 12 13 13 18 1 10 6 14 10 11 12 14 1 5 15 7 6 1 7 13 12 20 14 8 1 18 1 7 19 19 1 9 14 18 1 5 1 12 7 16 8 16 18 1 7 13 16 8 5 5 10 7 19 16 20 15 5 13 20 18 16 7 17 1 8 17 5 5 16 20 12 11 11 8
11 10 18 16 1 9 19 20 7 13 6 14 5 7 6 20 10 5 15 1 1 19 12 7 15 7 10 15 16 10 8 1 17 6 19 18 19 11 11 17 15 12 1 9 15 1 18 12 7 1 14 1 1 20 20 15 14 20 19 16 16 19 13 7 12 17 1 19 14 10 7 8 5 19 10 16 9 12 19 18 16 14 1 1 15 7 20 5 10 16 1 18 15 11 8 5 10 11 12
17 1 1 18 17 19 11 5 7 8 14 1 10 17 14 5 8 6 9 17 10 13 6 13 15 14 15 11 9 9 16 19 1 14 16 6 1 13 12 8 7 19 13 20 19 12 10 18 17 12 19 14 17 13 5 9 14 18 1 5 16 16 17 9 12 5 20 15 8 7 11 7 18 17 7 13 18 17 17 17 13 12 8 11 19 12 18 7 1 14 5 5 11 6 13 20 19 8 18
7 15 8 16 8 15 16 10 19 18 19 16 17 14 6 18 17 13 10 15 9 9 20 12 1 12 14 1 17 16 20 9 12 5 1 19 20 17 20 6 12 7 17 18 17 8 20 12 1 6 18 11 10 10 5 20 8 19 18 10 5 16 8 19 6 12 9 1 13 6 1 7 5 9 17 9 11 5 12 15 19 14 1 12 17 13 1 20 6 11 11 1 7 16 19 1 11 8 9
1 6 1 19 18 1 18 14 20 10 16 8 20 13 7 10 15 5 6 10 15 19 20 5 8 20 7 1 5 19 19 12 9 5 1 8 15 15 6 16 6 1 17 13 9 16 20 18 16 17 6 18 6 17 17 17 1 7 9 15 1 13 16 10 13 1 18 17 17 6 6 13 1 9 5 6 5 12 19 19 10 10 1 1 14 18 5 20 1 12 5 5 9 9 18 15 1 15 1
15 7 5 12 20 18 18 14 11 16 12 1 10 16 6 18 11 16 5 11 1 13 19 18 14 18 17 1 1 17 16 1 9 9 1 14 7 8 13 19 9 15 1 19 11 1 14 20 12 18 18 18 10 9 5 1 10 6 10 10 12 7 5 17 20 15 7 16 5 16 15 19 9 5 19 12 12 8 5 19 9 15 17 15 7 18 16 5 8 13 5 12 11 11 17 9 15 1 10
8 9 8 18 15 20 11 15 9 9 16 17 11 20 1 1 17 13 14 6 13 17 20 5 13 10 19 9 1 15 12 13 15 19 5 17 12 9 17 17 13 13 7 18 12 10 17 6 1 19 14 9 20 15 14 1 8 18 10 8 1 17 10 5 15 5 19 5 1 1 19 16 8 11 17 14 16 6 9 11 8 1 10 8 10 16 10 11 9 7 14 1 1 20 14 12 17 1 14
13 16 20 1 1 1 14 5 1 8 19 7 14 13 17 1 13 13 10 1 9 16 9 14 11 13 11 1 19 13 6 19 10 8 6 9 19 5 6 6 10 6 13 6 17 20 9 19 8 16 13 14 6 13 6 19 17 20 14 6 5 13 17 8 7 11 8 1 1 6 14 17 8 20 1 13 1 18 10 11 1 20 1 17 13 5 17 11 5 5 7 12 9 11 5 11 13 5 12
19 14 14 15 19 18 12 15 16 20 1 9 13 9 16 18 8 11 9 1 12 14 1 1 1 5 14 1 8 11 7 19 19 15 18 14 7 14 6 10 11 11 18 15 10 14 19 15 10 8 12 1 10 14 1 5 11 15 18 14 6 6 9 11 10 1 18 1 20 19 18 1 18 10 17 1 15 9 1 11 7 14 14 16 8 17 12 8 1 19 17 12 17 13 1 5 12 8 9
20 15 20 6 8 1 11 17 11 15 1 17 12 7 10 11 12 15 1 9 1 1 6 15 1 19 9 18 17 15 1 1 18 17 14 13 14 8 20 16 16 12 6 14 8 6 12 1 18 8 19 9 13 1 14 5 15 8 13 1 1 6 11 12 18 8 5 16 7 19 16 1 1 7 1 13 1 20 19 17 12 7 10 18 18 20 15 10 1 13 10 5 6 16 17 18 12 6 11
7 19 16 6 1 8 19 1 20 15 20 12 8 8 14 11 14 1 1 1 1 8 14 12 10 8 18 14 10 1 16 13 15 1 6 20 1 1 1 11 7 15 19 15 1 5 15 10 10 8 18 20 9 1 9 14 16 19 5 5 13 14 7 1 11 15 9 5 6 14 15 1 18 12 13 8 13 14 6 11 12 13 16 20 20 6 1 19 13 17 16 10 12 7 9 10 11 5 6
11 1 8 12 15 11 1 9 16 9 9 14 6 1 12 10 13 19 1 5 10 18 5 20 8 14 17 14 11 17 14 6 19 17 8 8 1 20 19 19 11 15 14 14 9 6 13 14 15 9 17 9 5 1 10 8 6 11 12 8 8 15 6 6 13 13 1 15 10 12 13 1 5 11 7 17 19 6 1 1 14 8 17 12 11 13 6 19 15 7 8 1 15 10 15 6 15 13 6
1 11 7 14 17 7 7 9 20 12 14 11 14 12 16 1 5 11 20 1 10 10 10 19 20 13 10 19 19 14 8 12 8 20 20 20 10 18 10 9 6 6 1 7 18 12 6 19 18 16 18 5 6 9 1 13 14 9 5 14 11 19 11 20 15 10 15 8 1 18 18 7 5 7 13 15 13 12 15 15 18 1 9 10 8 10 8 16 14 1 12 5 5 9 6 13 20 11 8
1 8 9 14 11 15 9 6 15 17 14 20 20 16 19 8 16 15 17 10 10 12 5 20 16 1 16 9 18 11 5 17 12 9 17 8 17 11 7 18 20 11 16 18 17 1 1 16 8 14 16 12 8 19 7 6 20 20 6 20 16 10 11 18 14 19 6 1 13 15 1 11 20 15 11 12 7 8 11 10 20 15 15 9 1 7 19 6 1 18 14 19 16 17 17 6 10 1 15
17 10 8 16 17 18 7 19 13 15 20 8 12 1 12 7 16 6 8 5 9 9 18 20 12 10 20 9 5 9 16 10 19 8 15 15 15 19 15 16 1 14 9 13 16 16 16 18 19 19 15 12 15 13 19 5 1 7 14 13 17 1 8 11 12 1 9 5 1 13 16 19 7 18 9 8 6 13 8 13 13 20 1 20 15 19 11 14 14 18 10 19 17 10 7 11 1 8 10
7 20 17 17 12 1 7 13 18 5 7 20 15 9 1 6 6 18 7 13 15 10 16 15 11 17 7 20 14 16 20 20 1 20 11 1 12 16 12 13 11 16 1 17 12 13 1 1 7 7 11 12 18 18 15 15 1 19 18 17 6 15 7 14 13 14 8 9 15 18 7 20 12 12 5 1 5 14 15 19 13 16 17 1 1 19 8 12 7 17 6 18 11 6 8 14 17 12 19
10 20 7 5 15 20 6 7 9 11 1 1 13 16 13 20 6 12 14 5 18 18 18 9 11 17 18 14 8 9 8 19 15 14 20 16 12 14 16 1 1 20 9 14 11 12 15 7 13 15 6 7 18 1 7 9 14 5 12 16 7 6 9 10 19 18 12 17 1 11 20 1 1 17 13 17 19 14 1 11 10 7 1 8 12 5 6 13 13 20 19 18 13 15 11 1 19 7 19
18 9 16 11 16 8 1 14 11 13 12 13 14 16 10 1 12 10 15 18 20 20 5 1 13 10 20 19 16 12 13 14 1 15 8 16 13 16 19 9 8 20 1 16 14 12 12 17 19 16 1 5 6 17 10 9 15 7 17 14 7 10 19 6 15 6 15 15 16 19 20 6 11 8 19 8 17 1 14 13 15 12 18 12 6 15 18 17 5 8 11 1 20 9 14 7 1 18 19
9 11 16 5 12 20 9 16 16 7 17 7 11 13 6 9 1 13 18 13 9 16 1 5 15 13 1 14 11 1 8 8 8 19 18 9 14 1 20 7 20 13 8 14 1 18 9 7 18 19 8 1 16 15 7 1 6 5 7 7 16 5 5 16 11 20 1 6 12 8 13 16 15 5 8 7 9 14 14 13 14 1 15 9 16 10 1 11 18 14 11 7 7 6 7 19 9 5 9
19 1 5 12 19 15 14 9 18 1 1 15 16 5 15 19 8 18 6 13 14 20 16 14 17 14 10 18 14 20 13 7 8 1 6 18 14 11 18 8 1 9 7 1 1 16 1 19 16 5 1 11 1 14 10 18 1 12 8 6 13 15 12 17 9 8 18 18 18 7 16 5 9 12 20 1 10 8 10 19 19 16 17 19 14 11 19 6 12 13 9 8 9 15 9 8 5 12 5
20 20 17 7 5 16 7 19 18 17 11 17 7 1 12 16 7 10 1 11 12 1 11 19 9 7 10 19 17 9 1 9 1 11 5 7 16 18 9 19 6 13 9 8 9 11 19 16 7 7 9 6 15 20 7 11 1 13 17 5 6 5 8 13 10 14 1 20 8 1 6 18 19 13 19 17 18 5 14 8 11 14 13 6 5 20 7 7 18 15 6 10 1 14 16 9 17 1 10
18 6 1 11 20 20 7 9 17 8 18 11 19 1 9 19 14 20 17 13 16 7 6 15 6 12 17 8 1 10 11 9 18 17 18 17 12 7 17 1 17 19 7 13 15 5 17 6 10 9 13 9 12 19 14 9 11 17 11 17 5 16 17 15 15 12 9 19 19 15 19 9 8 16 16 11 17 18 18 15 17 12 8 10 5 10 20 9 19 18 6 10 15 14 11 17 6 17 19
7 14 16 15 10 14 20 18 1 6 6 5 1 1 9 10 11 7 11 15 12 7 7 19 10 1 5 12 10 20 13 10 10 5 17 9 17 18 14 13 6 16 15 12 10 11 1 10 17 14 1 16 5 10 11 17 20 6 10 14 17 7 5 7 20 11 17 1 13 15 19 19 20 1 13 15 1 19 13 10 9 9 8 12 16 6 11 19 10 12 11 18 12 11 7 18 9 17 16
5 20 19 8 20 1 11 6 6 18 18 20 14 13 18 11 16 9 6 12 9 6 17 1 12 14 18 12 5 17 10 1 19 9 6 10 16 17 9 6 7 8 18 10 12 12 13 14 11 9 12 12 12 10 14 15 7 19 19 9 1 10 16 17 1 13 20 14 16 14 11 12 17 11 5 12 6 17 20 14 13 19 6 9 17 1 14 1 1 1 6 7 6 5 20 17 5 16 17
19 15 16 18 11 8 13 19 11 1 7 14 1 1 8 12 14 12 6 1 14 15 13 6 14 13 14 1 13 19 8 9 19 18 8 16 13 20 5 17 1 14 8 14 11 1 14 19 1 8 18 16 10 16 10 14 6 17 11 16 18 19 8 18 10 10 12 13 9 20 19 15 15 15 17 17 18 8 15 11 6 18 20 17 20 10 17 10 16 8 19 9 18 1 10 12 15 1 8
13 10 1 17 20 14 7 10 8 17 6 16 16 1 8 20 18 20 14 17 16 14 7 8 17 7 6 14 17 14 7 5 13 11 7 11 10 8 10 19 1 11 1 8 15 20 11 1 12 6 1 10 18 18 18 9 14 15 1 6 6 19 17 17 1 11 5 20 7 19 17 11 12 20 7 14 11 1 10 8 10 1 18 12 6 11 20 7 8 13 10 15 19 18 17 19 17 9 12
17 19 14 20 5 6 9 1 18 6 14 11 12 20 8 6 16 1 14 19 16 15 20 5 15 1 5 8 9 19 9 6 8 11 15 20 1 5 5 15 20 1 16 17 1 18 7 8 14 18 19 14 8 18 16 18 9 9 5 12 9 14 1 17 1 8 17 15 17 6 1 1 16 17 7 15 8 18 6 1 1 1 18 13 1 11 19 19 5 1 13 14 15 15 14 1 7 7 18
11 8 16 11 9 12 6 18 8 15 14 9 20 5 16 9 10 16 10 18 20 8 20 6 8 18 1 1 8 12 17 7 14 16 5 8 1 1 11 15 7 13 7 9 5 19 5 17 10 10 9 11 9 18 1 15 19 6 11 17 9 10 7 13 1 20 13 11 1 20 1 1 18 20 10 14 18 19 6 16 12 17 14 7 20 5 6 1 13 17 7 16 5 15 13 1 16 15 16
5 20 11 9 20 14 10 6 11 18 12 5 14 6 5 18 9 8 15 1 14 6 16 1 17 14 9 15 14 5 18 1 8 1 19 17 18 1 1 13 16 12 9 12 13 5 20 1 5 1 9 6 11 17 20 19 9 7 6 6 6 5 17 18 17 17 8 14 11 17 11 16 17 9 7 6 14 9 17 6 20 14 7 1 15 9 10 1 20 14 12 13 1 8 1 5 12 5 13
17 13 20 19 10 16 5 6 12 15 14 14 6 1 1 14 11 8 7 1 19 9 8 8 18 12 17 1 18 10 8 14 6 12 19 16 13 5 1 12 6 1 19 13 13 7 15 17 16 12 11 11 1 9 20 9 10 20 20 1 1 7 19 5 12 8 14 5 5 1 8 9 20 18 6 15 9 10 15 9 5 14 15 7 20 12 18 15 8 1 5 20 7 9 9 18 16 5 13
1 6 13 11 9 17 1 6 14 15 9 20 5 5 15 13 16 18 18 19 1 5 9 15 14 15 16 7 11 12 17 14 8 1 15 13 6 13 15 8 6 9 20 17 17 17 1 13 12 7 13 18 1 13 5 9 16 8 15 13 10 6 10 11 7 20 8 11 14 11 9 6 5 8 6 13 11 1 17 19 5 10 8 18 11 11 9 10 16 7 18 14 20 7 10 18 10 9 16
7 18 9 16 7 10 6 6 10 14 18 7 16 8 17 5 9 8 6 19 9 6 11 6 13 20 1 7 11 6 10 5 1 14 14 20 8 19 5 1 14 1 13 14 11 6 1 18 15 16 7 6 16 6 11 17 15 20 13 12 13 18 5 12 18 10 11 8 17 14 11 9 20 1 19 9 10 10 8 15 1 5 8 10 1 12 1 13 7 20 1 17 13 8 14 1 12 19 18
18 1 5 5 15 6 14 13 1 16 8 5 1 19 15 20 1 13 14 11 5 17 16 10 10 19 14 8 9 15 17 13 9 18 13 9 11 1 10 6 14 19 16 13 12 1 20 8 11 1 19 17 19 12 20 11 1 1 10 17 19 5 15 20 9 6 1 13 1 12 1 8 15 1 18 19 5 15 6 9 19 7 20 7 1 18 20 18 17 1 19 20 16 12 1 17 12 7 19
14 6 7 17 13 14 12 10 19 13 19 5 6 1 7 8 8 16 7 8 5 13 6 5 10 10 7 14 18 12 8 7 20 12 19 6 10 16 7 12 14 12 12 9 7 19 8 19 10 20 17 15 15 1 10 16 1 13 1 16 19 1 17 15 17 17 9 20 17 11 15 10 13 7 1 6 1 11 12 12 7 1 13 5 9 6 1 1 10 11 16 5 9 14 10 6 6 8 18
5 6 20 10 1 16 5 12 20 18 14 20 5 19 11 16 16 8 16 13 19 16 19 15 16 13 7 18 18 16 1 16 15 14 1 12 10 6 6 1 5 9 16 17 14 1 6 10 18 8 6 16 1 10 20 10 5 6 12 11 20 10 13 5 14 10 11 6 20 1 18 7 11 16 16 18 17 1 20 12 12 10 11 5 14 16 10 13 14 19 15 1 19 7 11 18 19 5 14
5 1 14 6 1 1 15 16 13 18 6 7 20 6 16 1 9 11 1 18 17 13 1 7 11 10 10 11 5 11 9 13 12 7 16 9 17 11 1 14 8 9 8 18 17 19 17 12 16 19 17 14 13 8 19 19 10 12 8 6 18 1 12 7 10 16 15 5 13 8 11 1 1 12 12 8 12 16 18 16 11 14 17 15 5 1 17 15 10 7 20 16 15 16 1 16 16 18 12
11 20 10 19 20 16 7 17 17 11 13 18 1 9 14 1 10 1 7 1 6 14 16 7 10 5 1 17 1 1 15 11 20 14 1 20 20 5 11 12 5 1 14 6 20 7 19 15 1 12 18 11 9 17 20 15 9 10 11 15 9 7 6 13 18 18 17 17 15 11 12 16 7 5 1 15 15 19 20 9 1 19 17 16 14 11 15 19 1 7 10 16 1 17 11 14 19 18 1
17 16 16 19 13 13 11 7 14 18 14 9 5 8 6 6 9 8 9 1 5 11 1 18 19 7 1 17 8 7 7 9 20 8 13 9 14 8 10 19 20 1 1 18 16 13 14 12 1 15 12 5 13 18 18 10 12 9 5 6 5 18 17 10 9 1 19 12 17 9 7 13 17 5 5 11 11 15 11 5 10 17 14 9 7 9 12 11 1 7 8 9 19 20 12 14 20 5 13
6 19 14 11 14 6 18 9 1 15 13 7 9 5 12 20 17 7 15 8 12 10 10 9 14 6 10 16 5 20 10 10 5 6 1 12 5 8 19 7 10 19 7 9 19 10 7 1 13 15 7 20 8 8 8 15 1 15 12 10 15 14 13 14 12 19 13 17 15 8 11 5 14 9 12 11 1 9 16 6 18 17 1 13 11 6 5 19 20 1 15 10 10 13 10 7 8 1 10
20 8 17 10 9 16 6 6 14 12 9 1 10 14 6 1 1 8 9 9 1 6 16 13 9 15 5 13 20 11 10 1 1 12 17 17 15 1 5 6 9 18 11 6 6 10 14 1 15 11 1 9 9 9 19 20 14 12 20 5 19 5 5 18 12 9 12 10 12 16 13 7 17 14 5 7 20 6 18 12 5 19 12 18 7 7 1 13 18 14 10 10 5 19 14 18 18 10 1
9 20 6 5 14 5 1 11 16 1 9 6 17 10 18 18 11 7 9 1 1 19 9 17 8 6 11 16 1 10 5 12 5 6 8 15 17 17 20 1 16 18 11 6 10 8 11 9 13 11 5 16 6 13 1 1 1 7 18 20 20 1 6 1 7 10 5 11 15 8 1 6 5 18 6 16 10 7 7 14 9 11 11 6 15 7 7 6 12 12 13 15 1 15 1 20 1 10 12
5 1 8 18 7 9 6 19 14 15 9 17 18 19 15 19 15 19 12 12 5 18 18 17 15 19 19 10 13 5 10 13 18 7 9 1 10 1 18 18 6 12 10 14 10 11 20 19 8 9 7 14 1 8 1 8 16 18 20 1 1 18 1 7 1 14 7 11 1 6 16 11 5 13 7 1 17 11 5 16 17 8 14 7 11 16 8 11 16 14 7 20 20 20 15 6 13 5 6
8 6 5 10 11 15 14 7 5 11 18 14 6 13 12 1 11 1 18 17 16 15 6 15 15 17 15 7 12 17 7 1 1 7 13 19 1 1 18 20 17 9 10 13 6 11 6 14 17 6 17 10 18 19 19 8 11 8 16 20 1 9 16 15 13 13 19 19 18 19 9 17 17 18 13 14 12 11 13 9 1 1 20 10 9 10 1 6 18 16 14 20 5 1 10 8 7 1 5
1 11 1 20 6 17 12 16 8 9 13 7 7 6 18 8 8 11 7 19 7 14 8 18 14 18 8 8 7 7 15 18 10 5 19 1 13 20 18 6 10 9 1 7 8 20 15 19 1 1 8 19 1 15 7 13 11 8 8 5 17 11 12 5 15 11 1 20 10 1 6 17 18 12 16 1 15 13 20 16 11 7 8 11 11 13 1 14 12 7 7 1 18 18 17 7 7 6 9
10 20 7 15 6 19 9 10 11 17 1 6 11 14 6 1 15 1 14 9 12 11 1 15 13 11 18 16 8 9 1 11 14 16 10 15 14 1 12 6 6 1 18 7 5 14 10 7 19 7 1 12 7 6 15 5 1 15 14 18 7 7 7 17 14 12 20 8 13 6 15 16 16 6 9 8 9 15 18 14 16 7 12 10 9 18 16 14 1 12 1 8 1 12 20 16 12 10 19
1 17 16 14 18 8 8 14 17 19 9 20 18 20 1 11 10 17 7 13 17 20 7 11 13 10 17 7 7 20 18 8 13 7 19 18 8 5 16 1 13 1 1 9 1 1 9 1 5 19 8 7 14 20 6 7 11 9 6 5 7 16 19 1 8 19 1 16 16 8 15 17 1 14 10 9 10 6 1 20 8 15 19 1 13 1 8 1 6 14 8 14 1 13 17 11 17 11 15
1 20 1 8 19 6 11 6 17 1 8 11 11 12 7 17 6 20 5 1 9 19 14 5 9 12 20 10 18 20 7 8 6 19 20 16 6 5 1 19 20 17 19 17 7 11 12 17 11 10 18 12 19 7 1 15 18 18 12 1 17 20 13 7 1 16 10 14 19 1 12 18 14 9 17 14 8 11 9 16 1 12 9 10 19 12 18 7 5 14 12 19 6 5 19 10 18 11 16
20 12 1 12 14 16 5 17 12 19 13 11 8 20 18 10 14 10 19 5 11 1 8 14 5 7 20 20 5 13 18 16 8 7 6 11 9 18 16 1 1 13 15 20 20 5 15 8 17 9 11 16 18 1 18 14 5 19 7 9 1 20 19 1 13 8 10 9 1 6 1 14 14 9 5 5 14 9 10 9 1 1 18 10 9 1 18 6 8 19 5 5 19 14 12 8 6 16 13
13 13 5 11 5 11 14 9 10 7 18 7 10 17 15 14 8 7 1 9 10 7 9 11 11 11 1 9 1 14 6 16 6 16 10 10 11 1 14 9 15 18 19 17 16 9 15 14 10 20 5 1 8 11 12 6 18 20 19 13 14 20 15 14 1 5 5 19 1 9 8 6 18 19 1 1 11 13 7 1 11 18 12 7 7 15 8 12 20 17 6 19 18 1 13 1 16 14 15
17 10 9 7 9 11 12 20 8 14 13 16 10 6 7 9 10 17 1 9 6 9 18 16 1 11 20 5 7 7 13 7 13 12 17 5 15 14 7 7 11 6 6 18 5 20 19 1 9 16 15 16 20 1 19 8 6 1 11 1 7 17 19 13 11 18 19 19 15 9 11 19 10 14 1 11 18 9 7 13 18 11 13 19 5 6 19 15 12 7 10 13 20 5 5 5 16 6 13
1 18 20 5 10 6 1 17 15 12 1 8 17 5 17 13 7 6 19 20 8 9 19 13 7 14 5 6 20 14 11 10 20 1 20 9 18 20 16 10 1 9 8 17 6 14 17 14 18 20 6 14 14 18 19 14 16 1 20 6 1 10 20 14 12 12 8 13 6 16 12 9 8 15 12 7 1 10 12 18 12 1 19 20 12 12 17 9 19 1 8 17 8 12 6 16 11 12 16
14 1 17 17 9 8 17 17 18 12 18 7 10 18 1 10 5 9 11 11 11 1 17 18 17 7 8 17 1 12 1 13 14 6 12 14 1 15 14 1 20 1 7 1 7 1 11 17 7 6 16 12 17 7 14 9 19 15 9 9 6 1 7 5 15 6 16 1 19 6 15 19 20 20 15 12 11 7 1 7 19 13 15 14 20 5 7 17 7 1 11 7 20 8 9 11 14 20 11
1 9 7 18 18 1 13 10 6 16 1 1 6 15 5 14 5 18 15 20 12 19 1 1 15 5 20 19 16 17 16 9 7 9 1 18 18 1 1 1 1 13 19 16 5 16 6 7 14 19 12 19 1 19 8 17 1 5 17 13 12 7 6 18 19 18 7 16 20 19 6 18 18 1 20 15 8 5 18 19 18 5 1 1 1 9 19 15 1 1 9 9 18 17 19 1 7 16 8
1 10 5 11 14 18 5 19 14 8 20 1 8 7 15 10 18 12 18 18 19 16 5 1 16 13 14 17 19 10 14 20 5 10 6 13 17 12 17 1 9 1 14 10 20 17 1 16 8 14 13 16 7 13 9 18 14 14 10 1 12 17 11 19 13 17 5 7 17 18 11 7 10 8 19 1 7 8 5 14 1 15 1 15 11 5 11 18 1 19 10 12 15 1 1 11 15 13 18
1 20 7 8 7 14 19 20 10 7 11 1 15 18 12 20 11 14 1 5 5 14 13 5 14 5 9 10 15 13 1 6 20 5 1 19 7 17 1 17 7 7 1 13 15 1 19 11 12 20 5 14 6 8 6 12 11 17 10 5 5 16 6 12 14 15 17 6 12 1 8 9 16 1 19 11 10 1 7 8 17 7 16 13 19 7 7 9 12 20 11 8 16 16 17 5 12 12 20
1 20 19 1 12 12 1 18 17 1 18 5 10 1 1 10 9 20 9 1 20 1 19 19 20 20 14 18 15 15 8 16 13 9 18 10 20 12 1 13 5 11 10 20 1 19 17 9 19 9 10 5 1 17 16 15 18 1 10 12 13 9 8 9 1 9 9 13 19 15 8 13 16 7 13 14 9 1 17 16 6 14 1 19 19 13 6 1 18 20 6 16 5 15 20 16 10 6 1
6 18 15 15 10 6 8 9 5 10 8 9 17 19 10 1 7 12 17 19 1 15 6 11 20 7 19 17 1 5 14 6 13 19 15 17 10 16 10 20 19 13 15 14 17 5 1 5 16 14 1 20 16 15 15 17 16 20 14 7 12 9 12 7 14 18 5 20 1 18 18 20 1 1 19 8 1 7 15 7 7 11 1 1 10 16 14 10 9 20 1 18 1 15 9 7 10 1 20
15 19 13 8 1 6 8 13 20 6 1 10 14 16 1 1 12 12 1 17 12 1 11 8 1 8 17 18 8 14 14 11 20 18 10 20 18 8 16 10 10 19 7 16 16 15 14 18 8 13 20 19 6 18 1 11 17 16 15 13 6 11 1 1 17 16 5 8 10 8 1 16 18 12 12 16 7 6 16 13 19 6 8 15 19 17 6 20 9 1 14 1 13 1 9 11 13 15 9
