35
3 17 33 25
13 26 1 49 22 34 49 39 35 46 25 49 34 33 50 14 25 30 45 15 28 1 1 7 26 15 21 1 39 4 31 46 1 12 48
21 4 24 16 1 43 32 24 49 14 40 50 24 45 36 30 1 9 1 9 26 27 4 18 40 31 1 13 7 1 29 48 14 28 26
10 2 18 11 17 47 1 1 27 32 7 1 48 47 33 30 5 4 1 39 13 32 24 38 1 32 26 10 1 9 26 1 1 31 50
1 20 1 50 1 3 38 39 1 6 39 20 1 47 49 36 44 37 34 45 15 45 1 1 10 40 24 16 35 2 14 24 40 15 26
6 49 1 1 1 4 5 36 50 1 16 1 5 7 22 28 30 1 16 25 23 48 30 8 1 34 43 1 1 15 1 11 1 39 27
1 1 38 12 28 27 37 41 49 26 1 40 28 23 10 1 1 16 5 25 2 18 5 28 1 7 45 19 6 39 43 1 1 26 1
1 7 17 1 34 18 16 1 1 1 32 19 10 1 30 43 20 39 14 38 3 35 7 1 10 39 10 5 19 10 16 47 10 15 1
47 1 40 41 1 43 1 20 1 5 33 26 14 1 3 21 8 25 1 39 29 32 49 17 1 1 4 27 9 41 28 25 30 39 35
16 1 1 10 3 26 1 13 2 1 1 9 1 15 31 36 40 25 50 1 1 34 28 22 17 25 36 1 50 22 20 1 1 22 22
19 22 1 15 3 23 38 6 40 7 24 1 30 5 1 1 35 43 36 25 3 16 12 11 31 35 34 43 47 48 12 32 9 10 27
26 29 28 39 20 16 47 26 1 48 16 7 1 1 1 43 1 14 42 32 7 1 1 33 29 9 35 27 1 29 22 19 19 36 1
1 1 4 33 26 11 40 1 19 28 25 4 5 36 19 16 20 1 37 42 7 1 1 17 43 26 1 1 1 28 26 1 40 47 1
1 1 37 35 1 42 50 29 1 5 50 43 1 46 29 45 4 7 1 13 12 31 1 17 16 31 1 40 4 1 15 37 9 5 25
36 22 26 36 47 3 12 10 1 34 44 30 4 20 23 1 47 28 40 47 24 24 32 1 16 19 31 26 22 50 19 17 1 6 16
32 3 1 3 33 32 1 40 44 1 36 37 15 26 13 30 1 38 7 17 35 36 1 11 1 17 45 21 43 25 19 3 3 1 13
4 37 30 18 45 3 3 43 32 42 16 40 5 1 34 30 1 3 8 31 10 4 1 35 9 13 26 1 41 37 22 31 50 32 40
1 1 1 1 44 9 48 11 26 33 9 6 2 15 1 23 23 14 2 1 1 27 42 35 18 11 14 13 25 3 35 27 27 43 41
2 7 5 27 40 25 33 43 48 35 25 1 42 1 32 12 1 8 27 17 11 40 20 29 1 43 2 36 41 21 6 1 40 29 45
25 43 4 1 26 4 26 46 18 9 2 1 41 14 38 23 42 46 10 40 9 1 47 3 1 23 1 1 26 1 7 32 45 7 2
12 40 1 18 32 1 47 49 14 33 42 39 21 33 1 5 50 34 24 32 24 1 1 34 19 9 2 44 22 36 16 6 4 4 1
21 1 1 24 25 11 15 24 1 32 18 35 40 36 1 48 1 32 11 43 1 22 32 1 7 42 37 29 14 1 1 38 1 1 10
23 30 39 43 48 7 23 1 45 48 22 48 30 50 2 21 22 1 1 9 16 48 1 1 25 40 10 29 12 18 18 35 1 14 1
1 28 40 9 49 1 48 1 1 5 50 8 44 1 1 47 38 50 18 29 1 50 19 1 9 20 24 18 17 33 1 42 6 1 2
24 1 20 18 50 7 7 46 19 9 34 15 1 41 25 1 7 1 1 25 3 49 31 43 40 1 1 1 7 1 29 10 5 12 15
44 50 43 24 33 39 27 1 37 19 45 28 30 19 19 4 35 45 1 1 32 47 15 37 38 14 21 19 50 48 1 23 27 36 19
40 29 16 1 11 1 16 12 42 40 1 1 50 1 20 37 48 8 13 43 22 18 42 1 1 46 17 1 27 13 40 1 24 21 1
31 7 33 36 15 4 39 5 25 12 37 1 17 7 4 1 1 32 4 39 11 1 44 35 30 48 41 21 10 30 23 31 17 1 15
41 5 45 45 22 36 40 35 33 35 13 1 1 48 49 38 1 20 15 11 36 46 49 36 1 1 1 20 26 20 10 1 1 1 40
1 24 31 43 14 23 24 46 11 44 35 1 1 2 37 39 33 21 31 40 35 1 5 13 1 18 31 18 2 27 1 1 19 1 21
2 1 11 1 17 19 17 1 23 50 44 3 1 14 36 33 31 43 47 1 12 29 40 46 1 36 28 28 47 1 21 2 49 10 11
15 17 15 36 17 4 1 19 32 6 1 1 8 1 20 32 38 27 1 1 47 1 50 1 1 9 1 46 27 33 1 38 40 40 16
1 44 1 32 16 31 1 23 2 1 19 45 6 14 45 40 6 1 43 38 48 43 1 25 1 6 47 37 50 32 3 4 13 28 12
4 21 1 23 2 38 3 23 2 12 1 3 10 22 47 22 10 33 31 1 10 37 2 11 27 37 12 3 5 2 33 29 1 18 16
12 45 17 1 21 30 1 1 27 42 29 47 49 40 38 1 50 6 43 1 5 1 5 7 45 8 12 1 1 48 1 30 1 6 3
23 1 1 1 5 1 46 24 2 25 20 1 7 42 19 27 32 1 9 1 31 1 46 1 1 49 24 9 6 23 42 11 2 43 30
