83
20 13 50 42
1 24 36 15 1 34 14 42 41 1 1 35 21 11 32 31 10 1 13 1 38 34 23 1 27 48 1 20 48 1 1 19 26 2 44 20 2 11 6 28 1 17 34 15 1 36 38 42 14 4 41 35 1 5 1 47 31 1 1 1 4 37 13 41 28 44 16 48 1 5 4 33 3 8 1 1 22 8 10 1 17 14 24
4 11 1 46 1 47 46 3 12 17 37 22 40 1 1 14 1 33 32 1 35 1 25 4 1 30 29 49 41 29 7 16 1 12 28 47 25 48 7 1 1 8 47 1 13 25 28 5 34 13 48 1 13 15 1 20 7 1 46 29 49 24 1 28 50 1 31 36 2 11 39 35 31 43 45 1 33 24 1 1 18 17 42
50 47 1 7 27 30 13 47 16 18 26 3 17 24 40 9 1 22 41 5 32 45 1 24 47 19 18 28 1 39 9 9 17 22 47 1 46 1 12 34 22 32 23 22 34 2 29 10 1 44 49 22 41 1 49 1 1 39 1 1 36 1 1 28 7 3 19 6 22 37 1 33 44 35 4 46 36 44 1 1 1 20 21
1 12 8 1 5 22 45 44 12 6 1 49 4 33 10 1 39 31 5 1 1 24 1 35 19 18 32 1 39 32 13 36 1 2 1 28 4 46 12 32 1 1 11 49 6 2 48 20 24 47 40 2 1 1 6 38 48 39 42 33 1 14 37 25 4 1 1 27 9 16 28 45 1 3 40 28 28 13 38 1 4 14 1
8 24 46 40 50 34 41 26 38 1 9 1 47 1 1 33 12 43 43 43 8 29 30 1 36 11 48 1 2 3 9 1 49 24 1 34 5 1 47 18 46 1 1 7 1 38 1 14 40 38 17 5 21 1 45 37 33 1 25 23 44 1 1 3 26 16 24 1 30 39 20 23 17 8 49 9 49 1 11 21 29 36 42
1 3 50 36 50 8 3 1 25 27 50 1 25 8 1 43 39 1 17 8 14 17 19 1 43 29 1 31 43 1 3 36 20 1 27 12 1 1 1 6 19 19 40 1 24 1 7 22 1 1 29 40 43 1 6 1 1 12 43 40 41 26 2 1 39 1 41 32 49 37 1 28 37 2 49 18 1 31 50 1 1 1 18
2 20 1 13 46 1 1 23 21 48 20 50 43 47 4 4 10 43 18 4 33 6 49 8 27 1 3 9 1 16 42 1 38 1 13 5 22 38 41 12 18 5 47 21 5 6 10 42 43 42 1 23 13 15 39 33 36 22 6 38 44 1 17 27 5 24 2 27 1 9 42 1 23 30 38 1 43 43 21 16 48 49 11
21 1 22 1 40 42 30 36 14 15 9 8 44 48 23 48 1 1 30 33 1 9 34 13 41 28 36 42 18 1 1 1 20 33 48 40 42 50 2 43 30 15 29 1 10 31 41 19 31 23 9 1 1 1 40 47 22 10 1 31 14 48 15 1 36 1 37 50 14 5 50 13 44 1 47 44 32 5 19 1 1 4 29
32 18 22 1 39 38 14 47 16 2 49 31 1 26 11 38 41 1 38 10 45 36 1 47 14 1 33 40 25 47 43 12 1 10 25 1 1 29 12 15 24 13 1 1 1 32 26 1 41 17 47 24 1 38 2 6 22 25 20 17 19 47 45 5 39 1 4 1 48 1 17 1 4 1 49 16 42 18 5 6 34 26 1
40 1 1 46 5 13 33 1 25 15 1 24 11 19 1 22 37 1 42 1 36 16 1 40 9 1 48 37 6 4 33 1 32 7 18 1 36 22 13 12 31 46 24 16 1 46 1 3 1 29 1 4 33 37 5 9 20 8 36 1 1 24 1 4 34 22 35 37 37 40 29 14 26 9 1 39 37 23 34 47 38 1 9
27 39 41 19 12 1 23 5 27 4 19 1 2 45 7 36 1 18 18 15 7 5 38 1 1 1 27 1 28 1 36 42 1 24 26 49 1 1 33 26 23 1 39 50 1 21 39 1 44 12 22 34 30 1 1 21 14 30 1 4 24 32 7 36 4 3 19 16 11 1 41 1 1 25 24 50 1 8 1 1 46 21 28
1 6 11 43 36 1 33 30 1 46 1 11 30 25 6 49 9 20 26 41 1 34 47 24 1 1 1 27 34 1 31 3 35 35 10 35 22 7 1 44 1 50 16 1 15 22 25 39 36 42 48 23 27 9 1 8 31 1 23 48 41 14 1 48 17 7 31 30 22 44 22 1 19 33 1 1 1 17 49 13 1 8 1
22 14 1 34 46 25 6 14 20 39 1 9 34 11 31 49 25 13 20 14 6 39 26 25 42 1 33 47 4 22 2 32 49 40 25 15 1 44 1 28 46 43 12 21 49 13 48 10 42 1 21 40 20 11 34 6 2 31 31 22 1 38 1 1 29 1 20 40 43 33 2 18 46 1 1 37 47 1 1 23 40 5 1
49 20 5 47 43 26 34 1 26 47 28 4 3 43 15 33 17 1 14 46 8 1 27 39 46 8 8 5 30 1 20 8 17 4 1 36 16 26 1 1 7 45 1 26 39 1 37 1 22 31 38 12 24 5 20 6 5 48 6 14 1 20 43 21 18 14 1 1 46 47 20 33 21 44 24 39 34 18 25 1 35 50 32
1 29 34 50 29 8 1 1 46 1 34 49 42 28 17 34 26 1 20 1 14 1 48 24 1 45 1 32 4 23 40 46 24 49 11 16 21 1 1 6 49 10 11 48 1 37 38 1 5 40 2 43 21 24 1 45 40 1 27 32 7 5 1 47 47 1 24 1 28 29 11 13 26 1 17 4 1 18 26 9 1 31 39
1 1 20 50 7 5 41 5 16 9 2 27 38 50 19 37 1 12 39 27 24 15 47 12 37 27 3 3 24 38 45 1 35 36 1 6 34 1 1 12 8 7 15 42 6 42 1 36 33 14 1 1 32 11 8 48 18 27 37 18 22 49 39 1 49 26 7 14 35 1 48 34 43 1 30 1 11 39 49 43 11 1 26
9 1 43 1 7 31 26 1 5 31 1 1 5 47 27 34 30 1 38 31 30 1 39 13 23 1 1 27 32 40 38 37 17 29 40 48 1 1 12 22 3 20 8 47 30 44 9 1 43 49 17 4 14 1 1 1 32 1 23 32 8 46 1 28 35 36 33 44 18 1 1 1 1 35 17 1 1 2 1 13 1 1 39
1 8 28 1 44 10 41 29 21 28 12 33 6 13 1 23 19 3 7 4 47 22 19 25 1 1 13 28 1 30 17 20 8 14 20 27 38 32 49 12 29 48 26 1 39 26 40 12 45 49 16 24 1 1 34 1 42 33 29 47 1 1 1 1 44 44 12 1 20 48 38 10 38 34 32 7 2 35 1 5 10 1 47
38 3 38 29 36 32 39 1 1 27 19 1 36 7 16 32 2 6 45 25 49 1 1 1 11 36 10 1 24 45 38 8 10 45 50 19 1 18 1 1 37 30 43 1 22 38 1 36 1 47 20 1 31 47 38 14 37 4 25 17 40 1 25 1 12 41 44 48 44 11 45 41 25 47 9 17 9 12 8 42 40 10 39
5 1 1 20 2 47 48 35 5 13 23 34 1 18 1 27 45 1 49 21 1 36 1 6 17 1 9 42 1 32 40 1 1 6 3 9 1 14 41 4 33 45 36 6 43 1 15 22 1 15 1 23 41 32 42 30 2 2 1 22 34 38 17 15 45 1 1 50 33 1 1 18 9 45 1 31 22 18 30 25 25 46 46
24 14 20 1 1 1 1 1 15 12 14 22 1 1 37 34 41 29 39 43 1 12 44 46 30 34 32 24 1 17 29 49 17 5 1 3 1 13 21 40 6 5 45 47 1 49 15 23 8 25 30 45 39 40 8 27 50 16 4 44 13 1 27 37 9 36 49 1 8 49 5 23 37 26 33 36 23 6 12 29 2 1 8
26 8 28 1 47 27 48 4 43 1 50 13 1 7 49 1 1 1 30 16 8 27 24 1 1 28 21 27 7 1 24 1 17 45 13 46 50 28 15 20 14 38 1 42 1 41 25 8 30 27 1 44 40 1 1 32 1 17 12 14 26 1 43 5 48 22 3 20 49 3 33 4 1 9 1 23 1 27 4 43 30 42 1
5 30 1 49 45 3 7 1 31 5 23 1 1 1 7 12 1 1 1 16 49 1 4 18 7 40 1 1 1 50 15 44 43 8 1 40 42 9 1 20 19 1 27 48 16 12 32 1 46 46 1 1 9 1 1 1 4 21 38 1 18 14 1 25 50 1 13 6 48 1 1 46 1 29 11 46 45 21 31 1 29 1 23
15 39 19 23 36 2 9 21 14 1 17 27 26 5 1 1 20 38 48 3 31 2 5 1 19 8 29 26 20 25 1 24 1 1 1 34 21 25 3 1 20 28 6 37 1 7 41 49 43 7 25 47 1 1 49 45 43 42 31 35 19 4 28 16 28 26 41 21 30 1 1 38 27 34 1 26 1 13 16 29 48 1 32
8 27 7 1 1 3 6 4 1 8 1 36 45 1 1 46 32 12 24 33 1 39 29 43 21 27 33 44 45 1 38 34 8 1 23 26 11 28 18 45 3 21 42 1 1 2 17 10 45 31 14 7 41 43 11 28 34 22 50 43 1 46 44 30 1 32 28 15 40 18 10 7 1 16 1 10 44 28 1 46 9 20 21
32 38 1 46 21 1 36 34 35 33 1 1 1 1 45 23 35 4 1 15 33 48 35 42 9 1 1 31 11 1 12 3 6 23 1 11 32 16 46 34 43 9 12 1 44 29 11 4 35 29 12 4 49 33 14 20 22 1 8 32 42 10 13 47 28 20 47 37 30 1 48 31 29 32 18 45 20 27 23 34 48 50 16
33 37 32 1 22 5 27 35 23 1 50 1 1 11 50 1 1 41 38 32 1 38 10 2 12 30 24 8 1 42 6 27 1 21 44 1 32 36 26 2 25 15 3 1 49 23 17 49 11 32 1 9 31 47 39 38 49 31 48 49 41 40 44 42 1 1 1 21 27 34 1 27 1 44 29 25 47 33 19 32 1 37 44
23 1 19 1 1 32 1 2 24 4 20 14 20 26 18 1 18 7 21 23 11 45 5 46 20 30 48 14 1 46 31 33 48 34 25 32 15 9 19 1 42 1 22 3 24 14 1 14 28 33 21 1 1 30 45 24 4 1 30 1 38 42 30 33 18 1 21 50 28 34 14 31 42 1 49 1 1 45 9 10 1 1 8
37 24 19 1 19 26 19 7 11 29 8 1 1 1 1 44 1 31 1 6 30 1 22 1 43 1 19 20 29 13 7 19 1 19 9 2 11 28 17 43 29 1 27 1 20 13 32 44 6 1 36 5 30 25 14 16 7 8 1 30 1 49 44 45 20 36 37 26 46 2 1 3 9 1 42 9 32 1 38 46 46 15 17
41 1 41 8 1 19 46 1 1 43 39 47 1 3 1 48 16 25 1 27 1 7 27 18 37 30 47 1 1 16 1 45 7 3 3 29 11 46 33 26 24 41 13 1 38 1 10 2 22 30 1 44 43 31 37 28 25 1 6 41 24 45 28 46 18 38 37 1 19 35 38 7 46 35 12 8 21 4 10 47 36 14 1
43 29 1 1 22 50 1 1 20 1 31 1 18 1 28 13 1 25 1 22 19 7 1 1 48 28 43 36 48 35 42 1 6 36 5 39 24 1 12 17 1 2 1 22 22 8 32 19 48 18 14 26 1 21 47 12 32 43 14 23 11 1 3 18 1 19 29 24 1 34 1 20 37 35 7 23 37 19 3 18 28 1 39
30 18 2 50 34 6 1 50 49 37 13 1 1 25 41 48 19 43 6 30 7 31 38 1 1 30 1 1 42 1 8 20 22 5 24 42 32 44 8 3 43 42 43 42 7 26 47 30 17 13 27 20 20 19 8 31 2 41 42 1 41 1 15 2 4 7 30 15 30 38 37 22 29 41 46 1 47 30 33 31 1 34 21
46 2 32 4 49 1 12 23 36 1 41 42 8 3 1 43 1 5 20 46 1 24 1 1 38 18 27 31 1 39 41 23 45 3 6 44 25 1 44 42 3 43 1 34 29 4 4 11 29 1 26 45 1 41 1 1 17 8 10 1 39 29 46 1 1 3 1 12 32 1 5 3 30 28 32 33 17 6 9 37 12 1 1
1 42 26 1 1 1 36 31 1 29 8 12 1 32 3 38 19 9 31 18 4 7 1 21 3 1 39 20 26 6 50 41 4 40 1 23 31 17 1 32 3 23 1 37 10 1 1 1 37 1 1 7 1 1 4 22 4 1 4 38 26 48 26 18 1 49 23 40 1 42 12 6 15 36 9 45 28 2 30 45 7 47 1
49 26 31 41 1 17 36 35 2 1 1 17 40 20 18 29 38 8 7 28 1 20 6 1 44 13 1 17 33 50 7 30 40 50 47 46 36 3 43 24 14 26 1 1 46 3 18 15 50 26 27 7 37 1 11 41 28 41 44 1 26 29 24 4 24 14 8 39 36 1 19 19 15 10 1 1 31 1 5 2 1 35 13
1 1 35 28 15 21 2 29 8 14 37 24 1 45 26 47 1 14 14 48 28 24 2 35 44 1 27 17 6 1 50 28 31 4 1 27 1 42 3 1 43 18 24 47 45 28 33 20 40 10 28 8 8 16 1 4 32 15 1 48 13 35 19 1 1 1 21 44 1 39 4 26 2 16 37 44 46 7 49 21 7 48 1
1 1 44 46 43 12 15 9 45 46 28 8 3 32 10 1 23 17 26 7 41 17 1 48 46 45 21 21 33 15 8 12 19 1 1 21 16 46 46 18 23 39 16 46 27 18 36 36 7 9 37 1 1 11 39 1 1 34 2 43 15 48 1 48 26 11 19 1 1 34 34 10 19 1 14 25 1 39 18 31 21 6 1
17 14 28 1 1 11 1 10 43 19 31 1 4 24 43 1 49 25 25 17 15 2 39 48 14 1 28 37 40 12 20 39 24 44 40 1 19 20 32 20 38 5 40 33 36 48 32 1 46 23 17 45 46 1 26 23 33 46 46 45 1 1 4 32 28 1 1 38 8 1 48 1 13 28 37 9 8 1 11 7 1 13 9
6 13 38 46 15 45 1 45 22 5 25 1 1 16 1 1 8 9 19 35 3 5 12 16 1 1 6 31 30 29 1 50 20 34 1 14 37 6 22 32 45 29 33 42 34 21 22 14 37 1 45 36 39 7 13 17 42 12 1 41 18 1 42 14 11 35 1 45 19 1 48 1 2 13 50 32 16 32 18 31 1 1 31
38 1 48 43 18 43 26 11 20 4 1 21 12 18 6 23 1 30 7 1 15 5 42 21 46 4 43 1 1 18 5 31 21 19 7 1 33 1 15 16 20 1 1 27 38 28 1 12 43 33 32 10 25 1 28 13 1 1 17 1 37 5 9 1 1 2 1 33 21 44 38 1 16 14 1 1 2 1 1 1 50 4 1
38 29 1 1 32 49 1 3 1 7 1 37 1 29 31 1 26 19 14 44 1 1 37 3 34 18 30 29 9 21 1 30 1 34 1 43 1 30 30 4 1 26 5 48 2 35 46 33 22 1 4 28 1 19 13 43 33 28 1 22 28 1 36 47 30 19 12 1 21 1 44 17 3 7 18 1 22 26 1 44 1 49 6
49 44 27 1 1 7 30 46 23 1 28 1 3 6 6 43 30 43 13 46 35 38 1 42 1 44 20 16 43 10 28 41 1 41 1 46 5 22 1 46 18 21 47 27 12 31 35 36 50 14 34 1 1 13 4 49 14 11 47 13 1 31 1 3 16 41 4 39 1 42 1 40 26 1 6 7 39 32 38 39 8 1 44
8 21 49 1 42 30 39 1 1 14 10 1 45 14 1 1 6 12 1 13 47 28 9 45 31 4 1 1 16 19 3 22 22 1 18 26 2 27 22 21 1 1 15 23 31 2 27 1 1 28 3 1 1 1 49 25 24 40 1 50 49 10 36 36 3 19 33 11 1 1 1 44 28 1 5 1 1 44 1 9 18 9 28
47 1 34 9 21 37 23 40 9 38 46 11 50 39 3 1 11 1 12 9 1 40 1 28 18 1 14 29 25 24 29 19 20 1 35 42 24 29 26 40 7 1 5 1 15 22 7 2 1 31 1 4 7 13 1 25 19 30 1 18 48 8 1 1 1 28 31 6 1 44 13 1 42 18 28 1 33 19 1 10 1 1 49
1 32 43 26 28 1 10 3 48 5 44 44 32 1 30 13 13 44 3 1 48 1 36 22 48 18 50 1 9 13 46 32 13 47 1 31 39 6 47 7 19 6 1 45 6 29 12 12 1 1 1 19 1 47 1 39 41 38 37 29 12 15 19 12 26 3 21 40 26 1 49 45 18 6 30 40 1 25 25 1 1 36 18
23 20 18 30 11 29 10 25 25 38 1 33 20 25 1 1 1 1 23 23 45 1 24 1 35 13 25 2 32 27 1 7 28 1 34 1 26 13 46 38 1 23 8 32 32 32 12 35 1 23 25 33 9 3 12 47 25 27 24 28 39 18 32 1 1 1 38 17 2 27 24 11 31 19 42 35 34 1 49 37 36 40 1
40 38 32 1 49 1 8 9 6 20 44 25 48 6 15 1 16 46 47 41 28 48 35 49 19 1 15 2 20 4 6 1 23 41 1 2 42 12 2 45 16 31 40 1 6 37 47 4 1 40 26 15 6 2 39 49 34 7 43 21 1 31 34 21 1 28 48 49 33 9 12 28 1 2 40 7 1 14 32 39 29 12 18
10 47 21 39 1 48 13 46 18 30 11 13 1 2 23 45 33 1 5 41 21 8 32 11 48 21 1 29 9 17 1 1 23 1 30 4 15 6 32 13 35 20 21 44 20 24 20 1 26 48 35 38 1 23 1 9 43 18 1 48 45 49 46 1 19 50 1 4 28 39 1 38 26 1 1 47 24 42 25 5 24 15 7
48 32 5 42 42 32 23 33 1 10 5 9 23 28 7 48 41 1 4 1 42 44 1 31 11 21 4 11 1 1 42 19 13 10 10 2 20 11 41 47 6 3 1 43 29 40 49 42 7 1 39 24 1 38 30 9 33 5 42 43 1 35 37 3 33 1 14 1 16 1 43 1 44 24 1 49 20 45 6 1 40 8 1
25 1 29 12 1 7 34 8 36 1 47 36 49 17 28 40 11 30 34 1 10 27 5 17 13 22 35 28 41 27 1 48 1 11 29 23 18 3 23 1 1 5 17 10 1 1 1 18 8 17 3 2 1 1 10 28 19 11 1 35 1 29 17 38 43 8 12 31 33 22 40 6 17 1 38 25 2 39 20 1 19 21 44
37 1 11 44 50 1 1 1 31 20 1 11 46 28 38 20 10 44 8 49 27 13 31 37 41 4 35 10 46 7 1 47 1 1 29 35 25 17 28 7 7 43 47 16 41 25 1 1 16 1 1 13 2 1 32 1 32 1 47 7 1 50 17 26 46 14 37 1 28 15 23 1 49 12 1 1 46 44 1 44 2 30 18
21 1 50 14 1 46 3 1 1 19 34 35 42 1 1 1 50 1 25 6 1 14 1 42 37 1 39 42 22 32 19 3 49 45 1 1 3 41 23 34 1 1 1 1 1 25 38 3 43 17 9 19 34 45 13 12 15 1 2 1 29 16 15 34 6 34 17 11 1 28 41 46 17 15 1 7 7 24 35 1 1 41 18
35 1 26 34 34 11 33 38 32 32 29 1 30 1 32 48 45 35 16 36 19 46 26 40 1 46 1 32 1 9 31 48 47 49 1 30 1 1 29 11 13 19 28 30 42 25 1 4 21 50 25 1 41 50 19 1 5 12 1 26 29 32 8 6 1 10 47 39 28 1 1 43 1 1 40 10 1 32 1 26 48 13 32
1 47 32 36 1 5 34 29 8 45 32 37 43 34 28 17 39 34 1 14 1 12 43 25 15 1 9 30 3 20 16 8 16 50 47 2 42 42 44 1 31 1 31 37 14 39 14 47 2 1 17 31 41 22 15 9 28 1 16 1 1 1 5 42 9 14 23 43 49 11 7 33 1 3 31 17 7 46 1 33 32 1 3
46 42 36 13 1 8 33 38 11 1 28 3 15 24 23 36 11 33 42 28 34 8 31 4 32 1 42 1 42 41 2 1 4 28 1 1 1 21 43 34 12 46 50 3 25 1 1 1 13 13 4 1 42 1 26 1 16 12 1 13 4 1 19 27 10 29 15 6 23 28 20 25 1 44 6 47 16 21 46 37 35 3 47
8 15 1 49 1 37 1 39 1 1 25 11 41 1 13 10 39 28 13 23 1 12 22 49 1 20 17 9 34 12 32 20 32 39 34 10 5 6 12 28 17 19 4 18 24 1 33 43 29 22 14 29 1 44 1 23 4 1 1 33 1 1 1 1 1 28 22 47 16 22 1 1 45 8 2 22 1 40 1 1 45 29 27
19 33 1 1 44 1 41 23 29 21 26 24 1 40 33 1 26 38 15 45 18 31 1 17 22 13 6 20 6 35 15 46 44 6 36 36 17 1 1 8 49 24 6 39 20 1 48 1 50 20 27 36 38 42 1 12 30 28 40 1 17 1 27 20 1 43 25 30 4 18 3 20 16 15 3 2 1 7 20 1 31 1 6
3 37 33 23 1 29 4 29 33 1 43 13 4 36 49 1 48 12 46 1 35 42 1 1 40 32 45 1 3 25 30 1 37 7 42 26 48 20 1 27 45 44 5 1 1 21 18 1 1 7 7 6 26 1 39 2 1 8 1 29 37 50 1 45 32 17 42 18 50 19 25 39 33 1 13 1 1 5 42 2 1 1 50
22 29 1 23 3 24 14 37 7 1 4 32 24 48 36 1 1 14 39 17 38 1 27 20 24 4 3 1 45 42 1 1 11 18 1 1 16 27 1 27 2 16 4 38 1 26 8 5 17 27 20 24 49 41 21 50 28 28 1 1 17 46 25 1 1 31 27 40 11 45 12 45 30 27 48 36 1 17 48 8 49 28 5
47 1 15 47 16 7 2 9 35 9 42 33 35 30 6 1 42 37 11 26 40 12 18 25 26 43 5 50 20 6 24 1 48 32 1 46 37 16 43 18 1 20 1 5 19 20 46 50 1 36 27 50 7 40 16 41 11 37 47 50 30 6 47 6 9 1 10 48 46 1 41 37 19 18 10 1 1 24 19 50 31 1 1
17 33 1 41 37 49 7 41 12 42 3 3 2 46 12 35 21 1 23 4 1 27 37 30 2 18 9 19 34 34 36 1 1 50 19 21 19 15 41 32 42 36 7 11 1 10 12 31 36 49 4 1 1 1 12 18 8 20 50 2 30 22 25 6 19 1 6 38 2 25 1 21 27 37 27 23 29 1 40 43 33 1 48
36 38 21 17 39 1 33 38 1 1 44 14 43 8 24 2 36 31 10 40 45 1 27 8 1 29 1 40 20 33 41 50 39 11 1 9 39 38 42 24 1 25 16 48 31 30 45 15 1 41 4 10 8 15 35 12 1 1 1 47 37 38 1 1 1 20 1 40 33 34 46 1 21 47 5 11 1 10 17 8 19 23 40
17 11 39 50 35 1 1 1 15 25 1 22 41 37 7 5 1 40 1 9 1 46 38 1 15 17 45 38 23 12 46 31 39 6 46 1 12 38 36 14 18 1 22 24 50 36 13 15 1 23 47 15 1 39 1 1 15 14 1 47 27 1 46 11 1 24 3 29 28 1 2 1 19 1 28 19 1 4 1 1 1 16 44
1 29 16 10 20 1 1 2 36 1 1 28 28 42 1 9 31 26 12 40 2 1 47 35 39 29 1 40 7 30 32 1 19 1 2 40 1 30 28 41 39 39 36 12 7 6 16 16 1 47 1 14 45 16 5 3 36 22 1 18 26 16 10 20 45 39 47 12 28 1 19 46 1 23 9 25 1 30 5 31 28 33 18
43 6 19 10 28 34 34 11 48 46 20 44 33 16 50 7 1 31 29 39 28 40 5 41 33 28 5 1 20 1 49 35 26 1 1 1 35 28 37 13 21 13 24 16 8 39 49 36 32 1 39 22 1 37 17 50 25 27 32 31 50 31 1 44 27 30 35 38 29 24 1 42 43 31 19 27 16 1 22 1 49 32 7
35 16 22 12 38 27 29 34 5 13 34 26 1 37 15 39 46 50 1 1 1 24 1 1 4 31 49 9 1 43 3 18 19 47 12 9 16 43 4 25 1 1 15 44 1 8 42 30 7 5 3 13 1 50 50 13 13 14 43 1 24 1 48 13 1 14 1 8 1 7 22 31 43 1 1 47 2 42 1 40 3 4 1
31 5 38 16 3 4 22 45 2 1 15 10 1 49 1 1 47 43 1 1 12 45 10 18 1 12 25 4 1 5 1 2 10 35 16 8 34 1 6 45 31 24 44 16 16 30 17 1 19 9 11 25 1 10 1 48 48 5 17 21 23 29 20 22 26 14 1 1 39 50 1 19 31 1 30 19 4 12 18 1 44 41 16
37 38 8 24 20 46 2 32 35 1 16 31 10 38 20 46 37 34 5 16 15 50 2 29 34 21 18 1 48 48 35 1 18 21 1 9 38 1 30 18 23 47 30 20 1 20 2 1 43 26 18 1 19 4 7 1 2 20 26 50 1 7 7 44 44 38 6 1 23 1 43 48 12 48 10 2 37 40 34 20 4 23 47
19 50 45 18 1 1 1 1 1 44 21 8 34 22 14 1 39 29 6 37 16 1 1 5 27 16 1 49 38 1 1 23 15 47 45 24 33 45 43 1 23 48 31 1 41 50 28 32 13 19 8 12 47 40 33 42 1 1 36 1 26 6 8 33 1 6 1 31 30 39 1 43 1 1 1 11 14 49 17 15 37 21 28
8 20 20 22 9 1 1 45 5 1 50 1 1 50 3 21 1 31 13 47 1 29 13 1 16 5 41 44 33 47 28 33 9 27 46 3 6 44 44 1 1 34 25 31 43 3 21 1 44 1 1 1 11 4 45 30 1 1 37 45 50 1 13 6 15 37 1 47 19 41 13 7 42 42 43 20 46 1 6 30 40 26 37
31 3 1 47 34 41 1 32 50 24 4 44 23 1 7 4 1 15 20 6 1 1 34 9 4 25 1 1 21 17 1 30 19 24 10 1 40 21 29 39 47 5 28 1 32 1 4 4 24 50 11 38 14 29 40 1 30 4 14 1 1 9 39 8 49 1 10 10 29 1 4 39 15 46 39 24 1 36 1 46 34 2 49
48 41 22 1 1 2 1 3 5 23 2 1 1 31 5 1 49 10 13 8 34 1 28 1 12 38 10 45 1 9 41 37 11 48 26 1 1 42 19 2 6 4 23 37 39 27 33 49 22 5 1 34 1 32 37 35 1 40 9 30 9 29 17 24 38 23 33 1 38 5 31 34 1 43 1 7 1 17 24 4 10 15 33
16 25 24 31 21 20 1 1 26 23 1 44 45 1 38 9 43 1 1 18 31 50 31 26 1 49 43 25 11 14 34 1 33 1 14 15 3 21 18 40 16 14 9 15 3 1 38 41 8 18 9 37 13 17 5 40 7 1 15 30 37 8 1 26 6 3 44 1 1 1 21 50 47 1 1 42 9 1 50 44 28 1 46
13 1 1 1 16 47 1 14 47 2 39 1 50 1 45 32 1 4 15 46 43 1 33 13 12 1 1 1 37 13 14 25 28 27 36 2 19 42 3 21 1 42 8 38 4 19 43 1 1 1 10 40 11 12 42 33 29 45 39 37 6 1 25 26 45 13 23 13 16 44 23 36 7 1 37 9 1 1 18 21 16 9 39
40 10 1 7 49 1 1 7 20 1 1 4 11 36 20 23 27 27 5 36 4 32 22 29 31 49 26 36 1 8 28 30 1 39 10 1 41 13 40 35 41 1 1 5 19 12 1 14 1 3 4 18 50 1 42 35 37 26 32 5 11 49 1 46 5 32 42 1 34 7 31 48 19 29 1 19 35 5 1 47 1 17 44
23 18 34 3 1 29 2 1 1 25 27 37 25 8 48 1 22 17 34 1 12 26 1 31 20 18 11 50 36 1 48 31 34 1 1 29 32 33 35 18 38 1 48 45 16 19 44 41 45 6 1 42 15 10 37 1 15 16 17 43 24 9 46 19 1 16 48 16 29 48 2 13 36 49 31 46 30 28 22 32 23 16 1
27 1 1 35 18 3 26 1 19 6 49 14 19 16 30 42 1 1 46 30 23 4 1 5 18 13 31 2 49 20 45 33 1 31 41 20 48 39 1 23 18 41 39 29 10 5 1 1 4 22 1 20 35 13 1 30 27 1 1 37 7 1 48 30 4 35 43 19 17 14 1 19 22 49 9 42 1 19 17 1 49 43 1
1 6 21 22 32 7 39 40 34 2 23 1 1 7 12 38 1 30 36 1 42 49 39 1 1 17 1 1 8 11 24 31 1 7 28 48 29 38 41 1 47 29 49 36 33 1 43 3 32 1 8 10 1 35 1 3 33 1 7 24 30 23 21 1 2 1 1 8 35 26 30 37 28 2 45 3 12 1 1 15 1 2 41
12 25 41 1 50 22 3 1 15 1 1 35 15 45 40 15 47 35 3 38 23 5 11 1 22 50 1 1 23 2 37 46 18 13 1 25 31 31 1 41 41 48 24 1 41 1 36 25 13 18 48 6 44 48 17 45 12 17 6 38 32 34 29 1 45 12 40 3 15 39 28 31 33 37 29 1 22 7 1 28 45 1 13
10 1 1 1 11 37 11 33 1 1 27 1 44 1 14 19 2 1 44 31 26 33 48 12 1 14 46 27 49 1 23 25 41 46 17 14 38 19 26 1 23 1 38 2 25 44 5 13 35 1 48 1 26 43 29 1 11 26 14 37 1 39 13 1 20 36 2 9 27 36 27 1 44 12 46 41 6 1 11 40 20 31 38
1 12 38 33 42 47 49 47 29 32 30 42 11 35 39 1 1 31 28 2 1 1 49 40 24 22 2 21 1 43 3 11 47 35 1 7 18 29 1 37 10 31 1 1 35 27 24 32 1 1 33 1 9 7 45 8 41 18 9 41 1 17 1 30 1 30 1 33 30 1 46 1 45 45 1 1 25 45 4 42 35 8 1
29 15 11 5 36 18 13 25 30 31 22 14 50 43 39 48 42 16 35 17 1 31 43 26 19 13 1 37 2 48 14 32 17 39 24 41 23 12 24 6 21 34 1 19 1 5 26 7 23 29 18 37 12 16 45 1 48 38 11 46 1 1 41 6 1 22 28 14 37 39 36 44 1 16 1 8 45 9 37 47 1 49 9
37 44 3 31 1 22 16 40 16 1 25 13 11 21 35 1 19 40 27 10 44 8 19 42 23 13 28 1 6 1 3 1 27 45 41 17 1 23 1 22 16 1 32 19 1 25 43 30 3 2 1 16 20 29 1 30 15 14 1 1 48 10 1 42 1 36 21 13 31 9 17 35 49 36 5 23 32 16 36 34 37 42 27
