63
25 2 31 9
47 6 30 10 25 40 1 29 31 2 28 1 50 30 1 46 1 1 11 44 6 4 22 45 1 47 33 6 42 6 35 32 36 1 12 48 1 50 5 40 45 1 30 40 6 14 11 48 25 1 47 43 44 1 3 10 44 46 41 1 7 50 13
1 12 45 20 19 21 1 5 1 4 17 35 33 41 48 6 35 17 33 1 1 37 32 27 1 10 32 9 1 38 1 26 6 1 1 1 1 32 1 19 1 1 37 30 5 31 47 47 38 23 24 26 41 40 5 12 9 7 31 6 40 46 1
8 23 1 46 28 47 1 41 1 6 2 45 4 49 12 17 43 1 19 1 40 5 31 1 1 42 10 23 18 30 27 31 16 1 17 1 1 14 19 1 14 1 1 15 31 38 11 9 1 39 1 30 8 28 48 1 22 48 36 49 2 2 1
44 34 40 22 33 46 36 24 17 27 16 28 50 18 1 1 27 1 12 1 6 40 37 25 14 1 6 1 1 1 1 45 19 37 1 1 8 20 1 38 1 7 20 20 1 10 36 1 30 25 1 25 27 25 15 1 1 10 25 8 22 1 17
39 17 42 30 30 36 27 34 42 46 11 7 1 50 1 45 17 48 35 26 1 5 40 50 1 45 31 35 41 36 29 4 49 47 1 24 25 4 8 4 12 12 11 3 44 27 1 1 11 20 1 37 19 1 1 1 37 21 1 1 1 37 34
15 49 36 15 35 24 28 40 19 14 44 10 32 1 1 17 1 37 15 33 18 37 28 7 1 29 5 23 37 36 39 6 1 1 1 22 23 31 1 10 5 4 3 1 1 49 1 1 47 36 49 39 1 22 1 29 1 4 35 1 1 1 1
13 36 1 25 15 12 10 40 37 1 7 1 12 23 42 12 26 44 1 1 27 25 10 1 10 45 1 1 1 7 1 7 3 43 25 36 1 22 30 16 1 1 39 35 15 9 25 1 38 40 37 7 47 29 47 20 1 46 24 22 40 31 1
41 17 21 27 19 2 45 6 44 10 32 4 13 36 26 1 42 50 8 26 24 44 16 27 37 1 1 13 1 29 17 26 3 14 37 1 30 16 44 36 1 3 37 46 3 1 41 31 49 1 1 34 31 10 1 1 6 24 5 17 1 49 1
32 32 1 41 18 17 12 9 8 1 22 38 1 47 44 31 24 1 38 44 14 21 6 24 8 21 14 37 1 29 1 1 48 24 7 7 1 32 5 1 10 37 1 45 13 1 1 1 19 13 43 49 34 18 29 47 19 43 1 30 2 42 6
44 1 38 38 49 35 1 3 43 1 18 38 40 1 19 1 49 5 49 1 50 30 25 35 41 22 1 22 26 4 46 45 1 13 13 21 26 11 3 36 30 25 40 29 35 10 40 24 35 24 1 43 34 1 43 1 11 27 19 49 49 1 38
19 2 10 1 17 30 14 48 30 49 5 49 1 1 10 28 2 39 1 1 35 1 32 13 37 35 37 13 40 5 7 1 48 48 50 1 1 40 4 1 20 13 19 35 39 22 9 34 15 30 1 50 1 34 6 39 22 12 1 36 8 10 1
34 1 1 38 12 45 48 38 26 35 19 29 1 4 38 26 50 12 38 18 26 29 39 1 27 1 32 1 45 14 1 34 23 14 5 8 2 41 49 21 50 21 42 46 1 1 1 1 1 23 1 18 1 36 16 1 29 32 2 9 2 1 22
12 28 1 1 16 26 6 1 3 1 13 1 36 1 1 39 45 17 4 25 47 31 11 40 20 1 1 32 26 45 1 42 1 26 47 36 42 24 28 16 1 13 27 20 10 32 1 4 6 21 40 46 43 41 2 45 41 3 37 7 45 29 2
35 32 1 1 28 5 19 33 33 2 1 23 48 39 45 42 25 25 25 1 19 40 42 22 1 1 11 6 4 11 1 44 50 47 39 13 36 1 1 30 42 1 2 17 15 27 3 1 33 1 22 1 7 1 1 45 1 23 41 10 29 38 45
49 40 19 48 22 50 15 3 8 1 47 1 28 33 1 1 10 41 37 3 1 21 30 19 46 48 3 24 49 40 33 5 2 1 29 6 2 45 1 31 23 1 10 38 37 11 49 1 34 44 31 1 12 9 23 31 8 18 1 27 5 12 37
25 12 37 45 9 22 40 35 12 32 32 39 41 1 13 1 14 8 1 6 28 2 1 48 1 29 1 14 1 1 24 32 17 18 37 38 44 39 11 4 16 1 35 2 1 25 24 23 33 46 28 30 20 24 1 31 32 25 1 1 41 1 6
49 1 1 24 33 47 17 6 1 1 1 42 2 25 41 1 22 48 8 1 33 25 26 1 28 46 1 1 20 33 6 1 38 40 1 40 1 37 36 40 3 33 29 21 43 30 6 47 25 3 1 28 20 44 24 1 1 38 21 5 10 49 4
15 17 41 6 36 1 1 38 2 1 44 12 40 1 42 14 26 8 30 11 35 1 27 1 33 1 1 1 46 16 6 50 20 44 1 1 46 34 28 36 35 16 32 6 22 1 16 14 31 40 5 13 48 25 9 19 9 8 12 44 10 1 38
41 1 37 35 1 1 37 33 1 25 32 1 1 1 38 23 1 33 32 4 4 6 41 46 1 38 34 43 7 35 32 11 1 27 44 27 27 4 29 28 16 31 14 1 25 48 28 1 22 19 9 7 20 36 26 1 29 6 45 25 37 16 1
14 23 1 7 29 1 25 1 38 27 25 48 15 1 12 36 38 25 10 47 4 3 21 40 46 31 45 47 16 9 13 35 38 38 4 15 1 15 1 47 23 1 15 1 1 46 49 42 2 36 29 27 27 10 40 1 6 22 1 1 11 1 2
18 2 1 26 37 23 5 40 26 46 15 37 49 1 4 50 1 21 29 2 9 16 48 38 34 20 49 42 17 1 50 1 22 1 1 50 27 35 17 10 18 12 41 10 2 25 20 20 44 47 1 10 1 3 43 1 40 25 1 38 44 37 31
23 22 1 30 29 1 15 25 45 7 10 44 9 1 1 26 21 21 28 27 1 5 1 39 13 15 1 49 3 1 1 15 37 1 48 1 41 31 17 16 8 17 35 1 47 1 28 1 1 29 22 35 7 35 23 1 16 1 42 1 8 20 20
24 39 9 27 45 1 50 38 46 48 10 10 17 44 1 13 15 46 49 50 19 41 28 44 42 39 49 25 36 5 1 34 17 23 6 19 50 42 13 16 44 48 9 16 29 44 42 5 21 21 25 5 1 7 2 38 1 17 8 11 14 38 37
16 1 38 50 6 1 42 15 16 42 39 7 47 42 16 13 2 30 1 41 1 3 36 4 11 44 42 23 4 29 12 41 41 1 20 26 15 12 7 34 21 9 47 1 40 1 2 46 21 45 1 1 23 32 1 24 1 33 11 1 47 29 18
18 17 1 1 26 37 1 17 15 21 47 37 24 20 1 48 50 25 4 20 33 39 4 47 10 7 42 39 32 41 35 7 14 10 3 1 47 31 20 3 35 9 43 1 31 18 18 1 28 3 1 44 2 46 1 32 13 13 3 1 50 22 47
4 40 34 48 28 31 47 3 50 8 1 2 30 40 33 25 42 31 3 1 3 1 1 8 28 32 12 1 42 13 20 1 9 35 27 12 44 32 39 30 6 13 29 23 37 28 17 14 42 1 11 26 21 33 20 1 3 1 46 28 8 20 2
9 37 20 1 49 15 37 1 37 19 1 24 10 30 9 5 15 20 5 28 26 49 18 47 41 15 27 19 23 36 5 18 7 24 24 1 39 36 1 33 1 1 37 3 21 9 11 20 1 46 10 32 21 27 13 40 23 1 37 13 41 48 1
37 42 29 48 49 41 39 25 16 20 1 30 15 37 27 21 1 11 27 7 24 50 1 1 1 19 37 17 43 19 1 6 35 1 47 1 15 50 5 9 29 48 1 48 29 37 39 3 8 1 42 45 10 1 19 40 40 34 12 17 19 22 45
41 13 6 17 48 31 23 1 1 15 12 49 36 13 36 1 49 39 49 7 38 1 42 45 1 30 1 46 38 6 44 24 44 24 34 10 28 27 1 17 17 50 30 47 45 1 1 1 1 24 1 1 14 1 1 23 9 40 38 17 1 36 5
48 36 1 39 2 13 29 50 1 36 3 23 1 5 26 37 23 45 15 18 1 16 37 1 22 1 50 2 26 2 9 1 1 39 1 41 17 49 15 12 25 5 29 1 13 31 21 11 34 45 17 35 25 45 22 9 5 36 1 7 15 36 28
1 23 1 8 16 25 5 1 38 23 10 44 1 1 33 8 47 11 46 46 9 13 12 1 3 1 49 1 13 33 31 42 37 8 1 50 16 22 1 45 19 23 1 27 14 12 8 37 41 42 33 49 1 1 1 47 1 24 46 1 50 29 2
26 1 9 32 15 1 45 1 1 44 1 27 1 14 8 40 36 1 19 24 15 39 49 1 15 23 43 43 31 17 1 1 39 33 1 26 8 28 1 1 13 17 39 1 2 41 1 14 35 7 40 40 9 1 27 47 29 1 21 30 39 1 39
48 11 21 1 46 23 28 1 29 21 3 24 1 31 1 31 35 3 10 38 1 40 15 14 1 39 22 1 1 1 10 1 1 2 47 1 34 32 1 1 1 35 21 5 3 20 11 14 1 47 16 13 34 20 1 1 16 45 1 44 38 38 38
25 27 21 7 9 9 6 1 31 1 12 24 47 1 22 43 1 1 42 2 23 1 3 13 3 1 34 40 23 8 1 17 6 30 10 24 1 1 14 29 21 1 17 5 1 32 40 13 11 27 16 17 1 29 13 15 1 31 1 3 33 2 14
14 20 28 45 6 39 27 49 8 10 27 1 43 37 1 31 23 31 1 37 15 17 1 1 36 21 2 45 45 5 35 4 3 1 1 25 1 1 24 4 6 1 5 44 1 29 34 1 41 1 21 1 24 9 26 14 1 41 38 16 34 5 11
29 34 37 30 37 1 13 50 21 7 1 7 25 9 22 43 40 40 5 43 1 17 50 44 25 1 43 49 1 47 28 47 31 19 1 6 44 26 38 18 28 29 22 1 2 21 16 41 46 31 20 42 40 1 37 48 42 18 1 35 46 9 1
50 24 14 37 33 22 34 16 2 1 1 1 4 1 47 13 37 6 46 19 1 46 34 46 1 10 7 1 24 49 1 33 44 1 1 4 47 45 4 34 1 21 40 17 45 42 44 1 41 3 30 31 16 38 28 1 37 44 27 35 10 49 6
20 23 25 1 32 34 40 37 28 36 19 48 5 44 1 37 31 1 42 1 30 1 13 47 36 17 1 33 4 1 35 1 15 39 32 22 26 6 11 1 40 50 7 8 49 3 3 28 11 1 39 1 35 3 9 10 11 2 15 1 6 6 19
1 34 1 1 25 5 1 31 3 8 48 46 15 11 6 8 11 2 48 13 49 1 28 9 6 1 35 1 41 35 12 1 42 9 1 6 9 1 13 15 4 4 41 35 27 6 1 7 11 48 13 23 23 13 14 12 1 1 20 40 1 36 19
21 1 5 34 11 1 40 31 11 1 11 31 2 28 25 22 1 1 16 1 38 13 50 16 14 1 16 12 16 44 47 1 50 21 35 23 1 32 10 41 42 8 1 32 48 1 25 19 1 26 39 26 9 18 40 35 13 1 14 14 45 30 24
1 1 48 41 27 25 27 5 14 40 43 1 1 39 7 29 7 49 40 21 22 1 24 1 8 1 42 22 50 39 1 16 34 1 11 22 44 34 22 9 20 40 12 29 22 8 1 7 30 22 44 28 31 27 1 1 29 11 35 8 1 19 2
1 6 44 1 18 1 1 41 21 27 3 1 38 36 37 38 42 11 3 1 18 1 1 10 22 10 1 20 4 38 31 7 31 10 5 8 12 47 10 31 36 14 4 30 10 1 1 17 49 21 50 31 11 48 13 40 41 29 13 31 8 9 39
48 16 38 44 25 1 1 1 50 10 10 1 1 1 30 1 12 42 39 14 34 33 1 49 1 2 24 25 15 1 30 12 1 1 1 1 39 33 5 7 40 40 42 19 24 46 1 14 1 41 3 49 1 1 40 30 14 1 49 1 12 31 1
50 42 10 42 46 44 6 3 37 1 1 1 28 27 31 14 1 37 22 13 41 8 1 1 1 1 36 34 35 10 28 15 1 33 32 1 1 36 45 23 38 1 50 11 1 29 2 7 31 31 24 29 28 17 11 1 26 16 42 16 16 18 3
49 7 42 23 32 11 16 20 8 12 38 1 8 33 38 1 4 9 25 31 1 20 30 28 37 23 40 16 28 42 10 21 41 1 24 22 42 28 5 41 38 41 12 3 36 46 1 8 5 27 3 32 2 34 16 9 40 1 5 6 1 21 38
1 7 22 17 1 27 5 1 45 43 40 44 25 43 44 1 15 13 9 36 13 1 42 1 39 24 1 10 1 47 11 44 28 19 32 10 6 1 41 1 27 13 31 33 39 13 26 29 40 1 46 7 1 2 29 8 18 1 21 50 16 1 5
33 2 21 15 17 39 1 49 12 2 26 1 1 30 27 28 1 1 10 16 26 1 1 25 33 47 1 9 1 13 45 4 5 44 1 49 13 42 6 46 41 24 14 42 48 45 1 10 25 38 20 40 9 1 40 16 13 24 12 1 20 24 1
1 48 33 19 49 41 40 38 11 1 11 1 16 39 22 1 23 1 37 47 38 1 6 34 32 27 41 31 7 10 2 6 39 39 1 31 13 1 33 46 32 8 5 5 9 14 28 4 19 38 50 34 1 40 16 32 13 28 26 1 37 50 49
7 46 21 39 24 34 1 38 1 1 32 45 1 19 22 18 20 6 45 1 18 5 2 48 28 40 37 11 45 1 1 49 26 21 40 42 28 43 1 1 36 23 27 18 1 1 31 6 1 1 1 13 11 1 41 43 16 1 1 45 37 50 45
25 14 2 30 38 16 16 34 10 1 32 1 39 1 31 35 24 25 30 1 34 42 47 9 1 49 48 44 1 1 1 19 1 26 27 28 40 8 1 4 1 45 45 43 1 27 4 27 49 45 21 23 40 1 6 33 1 27 24 35 14 1 39
45 29 10 14 1 28 7 40 8 11 35 13 1 1 12 15 16 9 20 1 34 18 22 2 1 7 37 27 41 1 24 12 43 1 20 35 24 41 1 1 47 1 1 1 31 5 12 27 1 24 24 3 28 46 22 11 23 15 38 30 24 17 1
1 37 33 32 27 6 7 35 35 26 1 14 1 38 39 21 1 28 21 1 17 5 42 12 28 6 20 16 8 46 37 1 41 7 25 35 24 1 17 1 1 15 17 1 27 6 14 17 11 35 15 43 11 4 23 1 6 19 45 1 1 2 28
7 29 35 44 12 32 45 1 31 8 1 1 48 16 16 1 47 32 6 17 1 15 25 35 43 1 4 14 34 2 17 25 30 29 48 1 44 1 48 1 1 10 50 9 1 24 1 44 45 11 1 10 39 40 44 1 22 14 39 1 44 24 1
1 22 33 20 33 1 1 15 36 9 44 18 1 30 4 16 23 13 9 41 39 29 38 24 1 25 43 31 29 24 16 10 24 33 40 22 1 10 1 30 1 1 16 29 1 41 34 5 1 1 46 38 6 9 13 36 21 1 50 1 27 11 7
44 7 24 1 39 3 9 31 5 5 26 5 2 40 26 30 47 1 25 35 1 23 47 10 4 49 1 4 4 1 18 25 8 21 11 15 33 21 38 41 29 46 7 23 1 39 47 32 33 33 16 27 15 18 1 50 2 1 1 46 1 12 27
1 9 5 1 1 2 35 27 37 23 26 16 18 47 20 33 49 23 20 28 14 1 1 30 1 40 35 1 45 3 1 1 18 1 1 25 18 33 46 44 18 47 29 22 20 34 1 1 32 38 2 15 11 47 21 46 21 46 35 8 4 1 30
24 22 49 1 33 14 23 15 39 12 1 38 1 2 42 4 23 30 2 37 1 21 34 11 43 36 38 35 14 14 1 15 27 47 1 1 23 17 1 50 1 1 6 19 1 2 9 37 1 1 37 46 35 22 1 47 23 19 34 38 23 21 1
17 1 5 21 1 24 41 39 10 31 1 23 38 1 47 27 38 16 1 8 1 3 1 1 7 20 26 45 35 22 2 10 13 4 44 1 30 29 7 11 18 1 1 20 1 48 33 18 26 40 50 6 40 12 1 44 18 42 45 33 32 12 1
48 1 29 40 34 1 14 17 1 7 45 26 31 1 45 36 13 6 31 43 48 10 29 41 37 46 22 9 1 10 1 42 40 29 10 34 8 49 12 16 34 1 34 4 15 20 50 1 1 1 9 27 38 26 1 44 1 6 48 30 42 49 44
1 31 40 24 27 10 23 47 49 1 1 1 45 16 1 37 27 10 23 37 19 45 15 40 11 1 46 40 1 31 12 6 1 36 36 40 4 38 18 1 1 1 1 31 14 3 33 11 1 1 8 40 36 31 1 28 1 23 1 29 17 25 15
15 27 1 10 39 31 28 1 33 48 11 16 50 6 12 4 3 1 35 50 1 46 11 7 15 50 48 1 1 25 7 47 41 33 1 33 30 23 26 1 28 28 34 30 1 15 9 1 1 17 44 47 18 33 1 1 16 2 36 10 12 1 19
2 4 35 1 9 36 35 28 36 1 41 8 15 13 40 1 1 8 25 1 36 35 1 11 1 16 3 38 49 43 14 48 18 28 14 49 30 35 9 5 9 3 3 21 41 44 47 49 38 12 6 19 11 1 16 36 28 46 26 25 5 35 25
4 1 7 12 2 25 1 9 16 22 13 45 12 31 1 35 11 9 1 1 39 22 1 46 1 48 9 14 2 25 3 1 15 24 13 36 23 6 32 7 49 23 35 1 35 1 44 1 3 19 15 26 12 9 1 20 24 37 1 28 33 14 17
