32
1 23 4 25
12 12 12 13 7 10 10 17 1 20 12 1 20 16 17 10 15 10 1 9 18 14 6 1 8 5 6 9 12 11 15 11
17 11 11 7 7 9 14 5 16 7 12 20 14 11 14 5 5 5 1 18 9 1 10 7 15 10 12 20 1 13 13 9
19 14 17 20 1 11 5 6 20 18 7 13 20 12 12 15 1 7 11 12 20 9 9 7 5 7 18 9 16 9 14 12
10 1 1 1 13 20 9 19 1 12 14 19 14 9 11 17 13 13 11 10 10 18 1 13 13 19 6 20 17 15 12 10
5 11 16 17 5 19 5 15 10 1 17 1 19 20 9 9 10 7 9 17 5 14 17 12 14 8 1 13 8 19 13 7
17 17 1 8 9 5 12 11 8 12 11 19 17 6 1 8 11 20 18 15 16 14 15 1 8 5 12 17 18 8 6 1
13 13 17 20 9 1 12 1 13 5 16 16 10 19 6 20 1 11 15 6 13 6 18 19 20 15 8 9 6 7 13 13
20 17 14 1 8 18 16 18 17 20 9 16 14 19 9 10 18 13 5 14 8 6 6 5 13 12 13 12 16 18 8 6
17 20 20 5 10 20 9 1 1 14 11 12 9 14 13 1 20 5 14 16 14 12 16 6 16 13 12 19 12 19 19 12
6 6 17 5 19 19 9 16 15 19 7 15 9 13 6 12 11 9 8 18 8 12 5 1 1 8 13 5 1 12 12 12
14 9 13 15 11 5 1 16 14 17 16 16 9 5 20 9 11 20 15 6 16 7 18 20 20 5 13 6 18 8 15 9
8 15 1 1 11 1 20 19 10 10 19 17 6 1 10 14 1 9 15 1 12 1 14 12 11 5 11 6 9 6 5 19
6 1 1 9 7 13 8 15 19 18 19 5 19 9 5 19 18 5 12 1 11 1 8 15 15 16 5 14 16 13 8 9
14 14 1 6 13 15 1 20 1 12 9 9 17 17 14 1 14 5 16 14 8 10 9 1 1 17 7 7 13 5 16 9
12 12 9 19 1 18 20 7 7 6 5 5 11 5 6 7 6 1 16 18 16 18 7 18 9 6 19 1 1 8 8 18
9 18 19 15 14 7 11 10 18 20 8 19 5 6 14 1 9 8 8 1 1 8 1 20 10 14 9 20 1 20 13 1
1 18 10 6 13 1 12 12 8 17 7 1 20 16 9 15 6 6 8 1 15 9 1 7 14 12 1 11 1 8 16 9
6 7 11 8 13 1 18 18 1 19 10 10 19 1 1 11 7 7 6 18 18 1 10 10 15 14 17 10 15 16 12 19
7 7 12 16 17 17 12 1 11 13 20 17 16 12 8 1 14 16 16 1 7 13 5 8 17 1 1 20 19 20 11 9
20 14 1 5 13 7 10 16 14 15 8 20 10 16 12 6 18 15 16 8 1 6 7 10 17 5 7 6 15 19 16 10
9 19 5 7 18 20 9 20 5 6 1 9 1 17 1 15 10 7 15 1 17 1 13 13 13 10 19 5 18 17 5 20
11 18 15 12 12 11 11 16 19 13 16 1 16 7 14 7 7 5 18 7 1 8 13 7 17 20 7 7 12 12 13 14
14 16 7 6 11 5 19 16 14 1 13 6 12 20 20 14 19 11 13 8 12 18 20 15 1 7 15 20 17 1 12 8
5 6 5 1 11 17 7 15 16 13 20 20 6 11 8 10 8 17 14 6 8 19 20 8 9 1 16 14 5 13 9 9
20 7 15 20 12 20 9 8 16 7 1 20 1 19 1 18 19 15 16 5 8 5 8 20 1 9 1 5 11 17 7 6
12 1 1 10 1 15 12 15 20 13 12 20 7 20 13 18 9 6 9 8 16 14 13 8 6 12 18 11 9 11 11 13
15 7 18 7 13 20 20 10 16 20 16 6 11 11 10 19 7 1 5 13 7 18 20 20 5 17 7 13 5 16 8 16
8 15 20 12 8 6 20 5 5 5 1 16 16 8 7 1 13 5 1 1 20 14 19 8 16 5 10 19 9 16 7 18
15 1 13 20 20 16 11 1 6 7 1 8 10 15 18 18 5 17 1 8 14 17 12 20 6 5 1 1 17 9 7 12
1 14 16 18 9 17 8 15 12 14 18 8 6 8 20 1 16 1 7 16 1 13 20 20 15 15 10 6 20 7 14 6
20 11 17 13 6 13 1 11 17 18 11 19 14 9 12 15 8 17 19 1 7 1 5 5 1 8 16 5 15 10 16 13
19 17 8 15 1 5 1 8 9 10 1 18 5 13 5 6 12 17 9 20 11 9 19 14 16 15 9 20 19 19 14 17
