48
10 3 31 23
16 31 45 1 44 6 42 15 19 20 1 1 39 22 11 21 1 1 1 49 33 6 8 1 18 7 17 48 11 1 1 1 18 17 42 13 34 5 16 1 3 1 36 47 41 48 16 15
42 14 5 1 40 40 27 48 37 47 29 14 41 19 44 1 14 19 1 21 40 29 1 7 12 1 20 18 1 40 1 30 8 1 1 11 14 1 10 42 7 1 34 24 46 26 43 41
27 14 14 19 1 27 6 1 37 29 1 11 38 48 1 15 1 44 41 7 49 28 1 29 4 24 35 10 1 27 4 18 20 3 1 30 1 29 39 1 48 1 17 1 48 35 45 1
35 3 48 46 39 1 1 23 2 31 1 2 34 43 13 20 19 25 43 1 40 50 15 7 19 38 1 14 37 16 46 1 8 34 43 32 48 46 1 17 1 10 45 1 1 38 35 1
5 44 48 1 19 8 44 22 1 17 19 11 41 27 48 22 1 1 22 10 26 1 44 1 1 41 1 19 3 21 18 31 37 1 32 34 42 11 1 1 30 38 11 43 26 31 7 17
29 21 22 22 48 17 30 25 24 19 2 29 49 1 7 12 36 1 32 32 3 48 12 27 7 43 1 1 11 27 1 34 1 45 7 1 1 21 15 1 1 41 26 22 1 39 1 36
1 25 49 34 40 34 30 2 19 24 45 5 42 13 25 19 9 41 1 22 35 1 1 1 47 30 43 7 22 35 1 28 44 44 1 33 37 38 25 1 15 49 25 35 42 48 12 1
28 1 1 35 19 37 32 48 10 33 40 16 46 9 20 48 45 26 20 14 42 42 5 4 37 28 1 16 6 25 1 1 1 31 15 13 1 32 17 41 26 1 29 1 14 1 26 50
1 28 10 1 1 28 1 47 16 36 9 1 24 41 40 3 3 10 1 1 42 36 32 33 37 1 28 44 15 1 25 50 22 16 23 28 34 1 2 45 49 33 1 37 33 2 15 18
24 10 19 2 9 1 48 22 30 35 40 33 1 1 19 44 41 23 8 18 16 12 38 25 38 39 35 22 1 2 18 9 24 20 22 35 48 34 14 1 25 37 20 6 11 1 18 44
47 24 48 9 6 27 42 26 29 37 33 1 22 19 1 1 2 9 13 31 45 10 35 37 11 1 37 1 8 29 10 30 14 1 1 3 15 1 16 1 29 1 21 12 7 12 1 40
42 5 6 10 12 1 11 49 15 49 13 4 5 1 5 1 28 41 12 37 40 15 23 44 1 20 4 50 6 30 5 19 6 1 5 15 3 1 11 39 8 1 36 47 50 24 8 16
1 29 35 1 1 35 1 1 2 21 47 1 33 19 42 1 5 1 45 25 7 20 39 1 16 34 23 18 3 1 13 43 25 29 8 49 27 37 33 49 25 21 27 41 46 40 1 23
31 8 1 35 27 43 30 47 31 18 20 2 1 28 5 46 1 1 9 40 29 9 33 1 40 46 1 2 34 40 18 1 40 2 10 9 6 37 1 50 22 34 47 22 45 35 30 2
25 40 49 1 18 2 7 48 8 6 50 6 2 1 12 37 45 38 32 1 28 1 7 36 23 5 1 2 4 46 2 18 4 1 18 7 1 26 16 11 1 7 1 32 1 25 4 1
50 8 19 14 14 32 21 11 22 27 49 50 36 48 38 46 1 36 21 37 1 1 38 23 23 31 26 1 1 1 4 49 7 13 21 27 17 22 30 23 10 4 46 19 38 13 26 39
18 44 1 1 30 2 32 35 17 42 42 5 33 41 1 29 38 22 6 5 42 38 1 1 13 3 1 1 45 10 42 8 38 1 38 39 42 38 8 1 43 1 1 50 1 27 22 13
1 24 23 48 28 1 30 17 20 35 35 1 27 1 17 43 19 30 4 2 40 49 50 5 43 1 10 32 1 1 30 24 41 39 42 49 23 16 9 1 35 1 47 22 11 28 8 50
1 1 15 1 42 14 23 8 25 45 40 36 49 18 45 1 1 50 26 1 1 7 8 48 25 8 46 34 30 9 4 4 8 16 1 8 16 2 34 1 8 14 16 45 32 35 12 22
28 48 17 48 48 22 1 28 1 44 12 36 34 21 1 8 1 1 1 17 41 25 1 46 48 7 8 10 2 3 41 27 20 30 50 22 10 22 1 9 5 1 15 15 24 43 18 1
36 19 44 45 23 1 40 9 28 10 26 40 1 40 1 18 50 19 14 33 1 31 36 1 46 35 15 4 20 1 15 46 30 21 28 9 1 36 30 1 1 1 3 1 1 1 1 6
1 1 27 19 43 22 20 14 1 31 16 29 28 35 41 49 26 1 1 1 1 24 1 17 11 14 28 1 50 48 40 22 38 28 17 5 1 1 50 19 39 30 39 39 35 1 23 36
1 16 13 1 1 27 1 1 1 12 16 9 49 47 1 49 10 9 27 1 16 36 42 1 11 49 20 1 19 45 1 32 1 44 19 8 7 1 32 1 22 14 23 37 50 18 1 48
21 16 1 30 34 12 46 1 34 1 17 29 42 47 21 10 11 16 1 48 1 9 1 2 25 3 45 21 37 1 1 1 19 1 9 14 32 1 21 45 8 1 37 1 9 1 1 22
8 31 35 1 40 35 5 19 31 15 30 1 35 45 24 1 35 1 18 20 32 6 27 1 41 1 21 12 44 11 10 38 14 22 1 41 1 30 46 34 40 33 34 2 33 21 28 29
21 46 30 1 35 2 43 15 34 1 30 1 1 1 37 1 1 6 11 1 24 41 10 1 1 31 1 11 1 6 2 1 33 19 49 20 45 42 39 39 49 32 48 17 1 1 38 1
34 7 34 18 1 46 41 49 37 1 19 1 25 21 1 35 29 24 1 32 25 4 42 5 33 22 35 16 22 32 36 1 13 1 6 15 26 41 14 36 26 1 26 19 9 1 36 31
14 38 1 1 25 1 14 31 22 1 38 15 1 1 49 34 40 1 44 1 26 1 3 25 1 39 5 1 43 1 37 1 24 18 3 1 11 22 28 25 47 48 31 31 23 1 29 11
9 1 23 1 11 33 11 17 1 24 6 4 1 23 50 41 2 33 12 13 45 2 29 6 33 2 34 15 17 31 40 1 43 1 12 1 29 30 31 20 34 29 36 1 21 21 10 1
20 6 1 1 1 36 40 1 44 26 38 11 16 45 49 22 47 39 8 38 18 1 1 10 3 14 1 1 45 42 44 1 43 1 25 27 1 13 23 18 6 11 30 23 1 1 13 19
17 46 11 30 2 5 20 11 47 41 42 38 34 49 6 34 44 40 45 39 36 5 40 50 27 33 43 47 33 1 2 26 19 1 21 40 1 10 46 30 6 27 24 33 41 22 1 6
14 10 5 1 15 1 1 23 19 1 43 10 1 46 18 49 1 13 1 20 34 42 48 43 5 24 1 16 23 17 25 4 23 1 48 43 20 18 21 17 43 1 1 18 44 3 16 14
13 1 1 35 49 20 44 42 8 23 1 18 21 38 3 1 50 12 46 18 16 36 1 34 1 1 40 28 15 8 9 1 1 5 10 3 41 10 1 46 1 46 8 1 36 11 26 32
22 39 1 26 1 8 10 27 32 33 12 13 7 17 16 36 1 1 29 1 31 5 12 1 33 5 16 31 47 12 1 1 17 25 3 24 1 25 1 1 28 17 37 34 1 46 9 10
33 20 17 19 1 14 19 25 1 1 29 23 28 12 3 49 22 30 22 18 35 13 25 9 1 43 46 30 6 31 17 41 8 8 11 3 23 1 39 28 31 9 49 29 15 34 1 28
13 13 27 15 20 20 1 40 1 38 7 1 22 18 9 7 33 30 3 1 47 1 28 1 37 8 47 38 23 49 6 36 30 2 33 20 19 24 40 25 1 46 13 10 41 21 5 28
21 7 1 38 41 47 49 39 3 19 1 19 17 1 1 22 48 19 34 1 1 23 30 18 1 3 39 12 23 36 48 27 47 46 3 49 39 24 38 42 1 14 1 17 41 32 1 27
1 32 34 50 1 36 20 1 1 17 27 43 30 39 33 13 10 47 38 17 28 15 2 1 4 6 35 26 1 21 49 1 1 22 1 1 1 3 45 1 19 28 1 37 33 2 18 40
1 35 37 47 36 31 15 1 7 1 18 9 41 1 17 49 21 15 49 1 38 45 12 1 32 1 1 1 50 9 20 1 1 14 1 36 9 30 19 8 1 27 1 22 7 27 16 12
43 16 20 50 20 1 24 21 12 45 40 21 21 33 42 30 40 27 6 10 19 36 1 1 1 1 29 1 1 39 1 8 45 22 1 31 32 1 8 7 1 10 30 1 6 1 47 13
4 47 39 15 5 2 4 30 6 18 25 33 27 20 34 37 9 38 29 16 45 8 9 1 15 16 17 1 1 1 30 27 28 2 28 1 1 46 14 48 1 37 1 39 1 44 21 1
6 43 2 1 7 16 22 30 1 1 33 27 48 1 36 11 1 30 31 36 35 23 9 10 36 46 20 36 13 46 35 28 44 18 50 29 5 41 42 36 17 15 47 31 1 41 48 20
5 17 37 48 18 9 15 1 1 26 21 43 1 1 13 50 33 17 8 49 30 45 38 1 18 8 3 38 39 1 22 20 20 50 16 11 37 31 1 3 24 39 1 26 25 1 1 3
35 1 12 6 38 3 25 20 1 1 11 1 1 27 50 36 4 42 27 42 21 32 1 47 21 1 1 1 28 1 1 1 1 4 16 9 1 16 33 35 16 1 8 22 24 15 41 46
28 37 12 10 23 43 30 46 17 27 34 1 42 40 31 1 1 49 36 1 15 24 44 1 26 25 44 1 1 2 1 7 50 26 45 5 38 13 8 10 1 48 1 39 1 30 35 19
18 15 38 33 30 48 46 45 36 1 35 23 25 39 6 1 10 49 47 24 1 11 43 24 1 1 17 14 32 2 23 23 48 1 22 34 41 31 1 1 1 1 9 49 8 1 31 1
21 20 21 7 26 1 13 7 11 25 8 1 34 45 26 1 1 40 7 18 40 1 1 20 18 5 17 20 38 5 33 22 1 24 9 1 44 34 34 1 25 1 19 40 1 10 44 27
45 18 48 4 1 32 1 1 45 12 22 1 1 45 31 1 14 15 31 45 32 43 1 3 17 1 34 2 39 10 1 13 30 50 25 42 18 42 10 1 28 3 5 29 1 2 18 22
