35
7 14 25 21
40 1 46 13 1 10 29 43 46 38 15 18 1 8 47 24 5 45 41 34 35 38 1 6 1 10 44 1 4 15 13 25 23 14 17
8 1 32 21 1 8 5 39 1 39 35 8 32 17 10 35 19 33 22 25 30 35 10 47 43 1 44 49 46 43 15 1 29 8 28
21 37 1 27 42 6 5 5 1 25 19 26 40 8 49 45 3 25 22 50 14 2 19 1 11 24 41 25 9 1 24 1 2 5 1
3 48 42 1 30 16 38 1 10 31 19 39 36 1 1 44 43 45 1 36 34 9 1 1 34 17 1 1 35 17 23 1 37 50 4
1 29 23 35 47 1 6 3 49 22 4 39 19 1 7 1 30 1 47 39 35 34 21 22 9 1 1 1 1 39 1 44 13 25 40
1 25 30 49 22 1 1 18 1 1 31 25 33 40 48 7 13 1 11 31 17 47 49 26 22 42 1 1 23 1 39 1 41 33 1
45 36 40 8 41 40 9 49 19 1 50 50 48 6 1 30 41 1 11 37 21 1 12 45 1 13 50 31 1 11 1 7 1 24 1
24 40 22 44 24 29 28 26 42 1 47 1 1 19 18 40 24 30 45 1 40 1 46 1 24 47 24 18 7 31 24 27 32 30 41
1 32 31 40 1 37 35 1 8 10 1 48 17 6 1 13 41 1 44 1 1 1 6 1 1 30 21 12 34 39 1 47 2 29 44
10 1 1 2 1 31 1 1 6 9 1 7 49 10 29 18 6 27 31 3 1 46 2 33 11 24 20 12 16 1 1 1 1 23 34
48 14 8 40 21 40 1 20 1 1 1 38 41 33 31 1 21 46 21 20 1 28 31 37 7 1 2 49 26 44 14 1 2 15 30
15 33 25 13 23 1 25 47 36 1 43 10 1 2 12 2 48 1 7 1 16 1 18 32 50 47 19 24 29 24 47 1 8 12 7
2 1 7 1 2 12 47 4 26 1 14 23 12 10 22 34 8 38 14 26 18 10 22 1 1 11 1 5 19 1 27 1 49 47 1
1 34 6 47 50 4 17 19 36 25 45 14 36 5 17 47 47 49 3 26 35 1 13 47 13 46 17 13 26 1 21 1 7 10 47
31 20 11 28 7 16 27 1 3 1 49 1 44 29 1 1 16 22 22 36 1 29 13 1 18 5 10 22 40 1 3 39 8 22 35
23 44 9 24 5 48 12 1 1 13 27 16 1 6 43 23 47 16 1 8 46 19 2 45 17 37 44 24 26 6 47 21 39 1 47
15 45 1 3 40 26 33 1 18 5 1 7 24 35 1 11 37 11 39 1 25 30 50 10 35 6 11 18 44 44 8 50 12 25 43
49 40 16 15 32 50 1 47 1 8 14 38 2 10 46 39 39 27 1 42 28 42 20 1 39 15 13 34 20 38 25 37 1 47 24
6 1 44 25 25 19 8 37 1 31 16 4 17 1 18 40 19 41 11 35 40 21 19 4 35 24 35 47 12 33 18 1 11 36 1
25 44 5 1 29 42 50 1 11 14 12 1 1 4 22 6 21 40 8 25 1 10 1 1 27 38 1 26 29 22 20 24 25 16 27
27 1 35 16 23 3 1 1 1 4 29 40 30 37 20 46 43 47 4 8 14 25 43 39 1 21 26 3 12 9 49 1 49 1 11
44 33 8 34 1 30 1 35 1 22 24 32 10 42 35 10 21 30 29 34 1 1 16 37 28 1 14 25 26 43 27 26 1 28 36
29 8 17 12 16 47 35 27 7 4 23 45 6 42 7 2 38 6 3 33 48 20 49 22 1 1 1 50 6 42 27 44 1 25 43
43 36 1 8 40 1 1 7 32 1 23 20 4 4 26 27 14 39 13 30 9 7 50 26 12 8 1 9 10 25 28 1 30 32 39
14 1 39 21 1 1 46 1 4 39 1 37 15 27 37 27 11 1 1 2 1 49 20 1 33 6 13 39 1 25 40 30 27 19 40
22 26 1 9 1 1 1 11 40 23 10 36 8 14 19 1 27 33 1 3 6 48 1 12 1 35 1 25 35 7 1 3 5 9 1
1 39 25 1 37 40 1 15 40 32 8 8 24 30 1 44 50 11 27 25 1 1 33 7 48 38 1 32 8 30 43 32 30 3 14
49 29 7 1 19 47 26 22 42 34 32 35 17 39 1 1 24 2 42 1 36 13 45 41 16 1 34 1 18 41 1 7 14 24 47
1 33 38 23 9 18 18 29 23 3 14 30 24 11 37 40 1 27 1 14 34 8 16 19 16 21 8 25 1 36 47 26 1 4 1
18 1 14 50 29 3 39 1 1 27 21 8 28 41 1 50 19 21 1 15 38 3 27 39 10 45 42 33 1 1 1 40 7 1 1
1 24 15 6 30 3 38 30 1 1 47 29 7 27 49 1 24 32 1 44 1 40 6 25 1 5 28 37 35 7 1 49 48 1 48
1 27 21 2 8 45 35 24 1 4 1 39 10 1 5 40 1 1 50 50 44 1 1 7 11 3 5 10 1 15 9 1 37 13 35
22 1 33 27 39 4 1 21 37 44 1 21 21 1 12 17 41 33 1 1 41 9 33 36 34 40 1 39 33 17 1 32 5 38 47
5 32 34 44 16 35 1 31 49 1 22 31 47 28 23 32 1 25 45 50 47 22 44 4 19 10 48 1 30 5 1 34 6 16 27
4 15 1 41 14 1 45 41 20 37 17 8 46 36 48 45 3 1 1 19 10 13 1 1 11 34 39 1 30 1 26 15 37 1 26
