47
28 5 29 25
18 18 41 31 2 50 37 1 33 15 50 1 32 17 41 42 41 2 9 5 15 1 22 5 1 10 34 43 26 47 1 25 34 46 23 1 1 36 23 1 45 25 20 34 1 1 38
1 15 3 37 17 5 38 1 41 1 26 33 1 16 1 2 7 3 29 22 1 32 15 43 20 36 1 41 20 13 3 24 32 1 48 36 16 2 50 1 1 1 31 47 45 32 1
27 47 8 21 1 21 22 37 1 23 10 1 47 15 30 34 1 9 29 43 1 39 2 24 1 11 20 49 15 46 6 1 1 18 22 36 7 23 25 2 15 5 10 38 40 1 24
1 21 29 43 1 18 6 1 23 10 1 1 3 48 1 23 8 9 46 44 43 40 16 8 1 25 1 8 25 38 14 24 27 1 3 13 29 1 8 25 10 22 37 8 8 37 34
9 18 35 37 43 12 25 8 44 1 31 20 1 10 45 1 18 4 29 29 1 46 46 39 5 35 42 28 34 4 49 17 39 1 1 24 15 1 31 1 45 19 50 37 26 4 15
16 12 3 17 1 13 45 4 1 13 1 11 17 27 41 18 1 9 45 40 4 17 7 1 48 31 41 22 1 1 12 31 1 39 1 24 10 1 9 32 14 42 50 1 3 10 1
1 1 5 33 44 3 8 13 47 1 1 1 23 1 45 29 18 49 48 1 1 4 1 14 37 6 24 9 14 37 42 1 1 9 23 22 49 2 18 30 20 50 24 6 28 30 42
32 38 1 1 2 18 30 6 4 44 36 14 43 33 33 33 11 5 1 1 1 50 1 37 1 36 27 2 33 12 31 31 29 3 28 30 29 9 1 1 38 28 11 9 17 1 4
50 47 7 1 1 17 32 1 47 41 2 10 31 1 26 23 14 31 30 36 1 8 36 9 8 28 42 35 1 21 1 47 1 1 34 38 32 38 37 15 1 49 10 49 48 38 1
1 36 37 30 46 14 1 33 36 30 1 21 1 19 4 21 9 15 30 17 28 1 15 13 40 9 15 37 39 47 5 32 11 1 18 22 4 6 43 24 47 1 26 44 8 46 22
18 19 24 42 10 21 38 33 1 41 9 22 29 50 28 6 42 1 41 1 30 5 1 1 15 33 1 1 9 7 22 8 20 26 1 42 21 12 19 10 49 22 4 42 43 43 31
45 21 46 22 16 1 9 37 1 15 28 20 1 33 33 38 43 1 1 25 14 30 8 17 37 1 12 50 41 50 1 46 42 41 24 1 21 50 1 1 34 5 1 1 1 30 47
28 31 1 17 44 11 43 44 2 46 39 20 24 30 27 34 36 23 4 46 24 19 22 29 1 33 1 39 46 1 2 5 24 23 45 17 24 18 1 25 1 3 1 24 43 1 28
39 35 40 37 1 4 45 13 1 21 1 44 1 3 38 41 20 1 1 12 1 9 17 14 32 39 1 26 1 12 1 1 41 39 3 5 24 4 1 30 1 1 15 1 46 27 38
4 44 13 49 1 1 23 1 18 35 35 21 17 18 1 6 34 25 10 1 30 41 27 16 1 42 29 36 23 21 1 18 14 22 2 11 10 10 21 1 1 24 1 24 38 20 41
37 14 25 1 45 49 45 1 9 12 2 1 36 9 1 1 20 32 42 50 4 1 1 28 8 17 24 37 27 19 9 35 1 34 15 41 28 1 1 36 1 29 38 42 13 37 13
37 10 1 1 1 30 1 26 30 19 16 7 30 1 1 17 1 37 20 9 1 1 16 1 8 11 27 34 4 1 20 31 49 22 13 33 1 28 22 27 30 9 46 11 35 24 1
8 6 21 20 11 20 2 48 45 3 1 22 50 14 2 16 37 28 25 36 46 37 48 1 39 1 12 48 1 10 43 14 48 1 32 34 43 47 38 8 44 1 1 1 18 19 27
1 49 31 6 34 47 1 24 34 41 44 22 34 24 17 9 42 1 43 35 4 31 27 47 9 22 11 6 12 8 27 24 45 1 21 18 43 24 34 1 32 38 9 49 8 1 11
1 16 12 41 1 24 6 1 47 22 1 20 28 19 30 1 1 24 20 36 39 1 23 1 35 14 18 22 39 38 42 29 27 45 23 1 8 1 4 9 40 18 1 47 45 33 46
21 19 36 25 23 48 1 18 21 44 10 1 4 1 30 7 28 26 49 35 1 34 20 48 1 10 1 29 44 45 47 19 6 1 1 44 3 30 21 41 1 2 18 47 1 4 6
28 20 20 45 2 28 15 10 47 26 1 10 18 18 1 1 1 4 17 2 1 31 1 4 25 17 44 1 10 12 39 24 24 39 30 15 1 40 5 45 38 25 33 31 1 9 42
37 34 19 36 40 13 13 1 8 19 1 12 37 1 46 5 33 1 10 16 1 36 36 1 16 27 1 22 43 29 29 1 9 48 1 28 36 32 7 24 1 20 1 21 7 23 50
47 5 1 1 2 17 47 1 28 44 22 50 23 25 11 1 1 45 33 12 46 18 19 1 6 23 1 33 1 24 49 1 32 46 49 1 33 42 4 7 39 1 28 36 25 29 46
33 44 43 43 34 1 44 40 1 28 41 16 3 31 1 1 6 12 1 42 25 1 3 45 1 27 13 22 45 41 30 22 20 1 1 3 27 43 16 8 1 41 14 10 40 45 7
14 30 1 20 1 1 9 1 1 38 9 12 22 21 2 16 37 3 46 50 18 50 27 40 1 39 1 6 45 31 7 1 3 42 13 7 43 48 1 1 35 33 1 40 50 1 25
35 42 45 1 21 8 45 31 28 17 38 25 18 13 48 22 1 44 11 1 1 30 13 20 17 17 1 1 13 39 15 28 1 1 44 13 7 49 35 43 4 1 10 1 41 46 16
31 29 50 6 43 1 36 4 36 39 47 27 1 39 28 35 44 35 32 46 14 23 7 38 25 42 19 9 50 23 1 25 21 37 27 1 39 1 40 7 31 1 1 32 39 28 43
1 37 1 21 40 25 1 29 1 41 1 1 1 31 1 30 12 8 18 1 21 43 18 2 13 1 31 32 4 1 6 29 1 26 19 1 48 23 24 1 7 37 7 4 34 21 1
1 12 1 41 46 1 14 1 44 1 38 44 21 43 28 28 1 12 10 25 28 1 16 49 44 25 43 1 12 13 48 1 40 5 1 27 36 10 33 16 7 48 18 1 21 43 28
8 11 38 18 44 27 50 8 2 34 13 1 43 7 16 49 3 43 26 12 25 23 6 1 20 32 1 12 9 1 1 3 44 38 31 7 5 31 47 12 41 43 7 9 2 1 43
12 27 1 23 1 1 31 50 33 49 1 26 49 21 35 42 35 1 1 30 37 40 16 49 1 24 32 1 37 50 9 17 16 1 1 43 8 30 20 1 7 47 33 15 24 43 2
1 30 9 15 1 11 43 49 43 12 37 1 12 1 33 50 47 33 8 23 47 24 1 35 1 18 19 50 45 20 34 45 26 8 19 33 1 46 44 16 25 1 1 39 1 25 29
18 1 26 8 27 48 6 21 5 10 6 47 15 20 2 28 41 17 42 1 14 50 39 4 50 1 34 30 3 27 1 20 1 18 44 18 15 22 4 44 27 8 9 49 42 40 1
16 25 30 32 1 47 41 1 33 7 50 7 1 10 1 47 1 12 30 1 13 5 1 7 19 1 47 28 21 13 11 14 30 8 34 15 1 35 49 38 1 1 4 2 1 2 47
13 50 1 28 27 24 17 46 17 3 24 43 31 24 49 15 22 1 6 49 16 1 1 10 1 33 18 5 34 8 4 1 31 1 32 34 1 48 36 40 50 37 30 19 6 18 31
1 12 18 3 33 16 17 6 40 6 3 49 36 25 43 29 1 21 23 33 1 4 1 1 41 1 6 1 12 31 27 19 23 1 47 26 40 35 5 1 1 24 25 41 12 24 17
1 15 25 27 35 1 30 41 50 39 44 27 5 10 1 1 34 18 49 9 8 4 1 49 1 8 38 49 50 5 8 10 1 42 43 1 34 39 43 50 23 49 16 24 34 12 1
34 22 1 10 17 28 30 33 1 28 12 1 29 35 48 9 1 41 31 34 2 44 1 17 1 13 1 1 19 1 31 1 22 1 31 37 7 49 27 39 12 39 3 46 15 47 40
6 1 40 35 19 34 18 49 42 20 8 34 1 36 25 8 41 9 31 1 1 11 48 43 49 17 1 36 42 11 25 24 33 42 4 31 30 1 1 45 23 50 1 42 1 1 27
24 5 34 33 1 27 1 3 20 8 13 1 1 24 2 1 13 31 7 38 1 42 2 10 1 39 11 50 28 5 33 24 39 42 7 2 32 9 48 1 5 8 48 37 47 8 8
16 1 43 41 1 22 17 16 40 1 17 25 1 1 3 17 22 1 47 35 23 43 20 13 10 23 37 16 1 1 23 23 16 36 46 15 42 12 39 25 28 26 10 47 49 1 9
24 1 1 39 49 42 1 32 10 10 44 17 1 32 5 41 23 31 1 37 6 34 20 31 39 30 16 1 7 1 22 29 45 39 1 48 32 13 18 24 33 1 15 20 1 1 13
33 27 41 21 45 1 22 5 24 47 14 38 40 12 1 29 41 49 1 10 7 38 49 23 1 45 1 22 14 47 1 35 18 46 15 1 25 1 1 1 1 48 1 19 1 27 30
15 3 30 23 21 36 7 10 3 8 23 42 17 24 1 48 1 29 26 45 39 21 1 45 34 29 26 1 43 44 30 1 1 5 32 1 20 13 1 1 4 21 3 45 12 4 1
1 34 1 21 14 16 39 43 24 1 8 41 33 34 16 1 23 3 48 1 18 1 38 33 10 1 48 1 38 30 22 23 6 42 28 47 1 30 5 31 38 14 40 28 36 1 6
1 8 23 47 1 1 22 1 19 1 11 15 4 6 30 27 22 19 5 1 13 48 1 25 45 43 1 5 17 38 3 28 7 1 37 20 1 35 48 13 13 19 41 1 14 7 24
