56
19 43 49 45
8 1 1 17 17 15 7 13 13 16 10 5 16 1 14 18 15 9 10 10 1 15 1 1 20 20 19 8 18 1 12 14 14 8 6 11 19 18 19 13 17 1 1 15 16 19 19 17 15 11 7 1 9 1 12 5
6 1 11 10 14 7 10 13 9 8 6 17 5 15 12 5 17 5 6 13 13 8 5 5 11 1 1 18 20 15 7 13 5 7 18 12 5 9 20 10 20 19 18 1 7 1 9 16 9 10 6 10 1 5 16 13
7 16 14 18 18 11 15 19 1 16 14 7 1 14 16 11 15 11 5 8 8 5 14 1 9 11 20 5 8 13 9 6 12 5 8 1 10 1 17 14 14 9 12 20 17 10 5 1 19 16 15 20 1 10 1 6
13 16 5 6 16 16 10 14 15 17 12 17 9 8 1 17 20 15 16 15 1 5 13 9 20 10 13 18 19 9 6 14 7 19 9 16 12 20 5 10 1 8 1 13 16 19 8 14 14 15 13 14 1 11 16 1
1 15 13 10 11 6 13 15 17 1 1 16 18 8 12 16 1 18 8 6 16 7 7 15 17 8 12 19 1 12 15 18 9 20 19 14 16 19 7 10 7 10 13 1 16 16 1 17 5 20 8 14 9 10 5 18
6 20 8 16 5 5 12 6 9 9 9 20 16 17 7 5 10 7 9 5 19 12 7 8 18 12 14 10 17 19 7 1 6 16 5 16 17 8 1 9 13 12 11 1 17 12 6 16 17 13 7 16 18 18 9 12
1 11 20 16 11 20 17 14 18 8 20 20 15 11 20 5 5 10 19 11 16 6 9 15 12 20 20 15 6 5 8 5 9 13 12 1 5 17 17 17 13 20 13 20 1 19 5 8 12 16 6 13 20 5 9 12
10 15 14 19 9 7 10 7 1 7 20 8 15 7 19 6 11 10 1 8 1 1 1 1 9 20 14 18 8 13 13 10 1 18 19 20 11 7 13 10 1 15 17 11 12 6 11 19 12 20 1 20 17 8 5 9
10 15 15 5 1 17 20 14 15 9 1 7 19 20 1 5 15 9 17 12 7 7 12 12 1 20 20 20 20 1 7 9 19 13 6 8 9 9 1 17 10 20 5 11 18 17 11 6 18 16 9 16 6 6 12 18
14 1 20 11 14 10 11 13 1 16 9 13 14 6 9 6 20 10 12 20 5 16 11 6 14 5 1 5 6 8 5 1 14 11 15 6 1 7 11 8 13 10 15 6 1 15 19 6 12 11 10 6 14 9 17 18
16 20 1 1 19 14 1 8 6 14 13 14 18 15 12 7 14 1 18 20 19 1 20 10 8 20 6 14 7 5 1 16 11 17 14 13 10 15 1 6 5 1 13 13 15 19 12 11 15 19 1 1 13 6 18 12
8 10 11 8 17 13 18 9 9 1 14 7 17 20 17 8 6 15 14 18 15 11 7 10 14 18 19 10 1 5 12 10 12 12 12 1 13 17 15 20 10 8 1 9 18 1 20 7 16 14 9 11 11 10 7 17
5 18 18 11 9 12 10 20 7 1 16 8 13 11 1 10 12 15 12 19 12 17 14 14 6 19 17 11 8 19 9 6 8 11 17 20 1 20 9 5 17 17 6 5 15 15 14 1 7 5 18 17 9 13 8 13
13 13 9 9 18 10 14 9 11 19 5 1 12 13 20 8 8 8 20 19 8 11 10 19 20 16 15 15 1 17 9 16 18 1 19 17 1 12 14 8 11 13 18 9 5 18 11 17 10 20 14 19 6 14 15 7
7 1 11 15 5 10 1 5 13 5 6 14 9 20 13 17 8 7 5 12 13 9 11 6 6 7 6 20 8 5 1 12 13 16 17 19 7 9 11 20 8 9 7 1 12 8 15 5 10 10 12 19 20 12 5 16
5 20 15 12 20 14 11 5 15 1 11 13 20 19 9 20 17 12 17 1 11 14 1 6 12 10 12 6 19 18 15 1 16 1 5 6 12 17 1 5 19 20 16 17 10 7 18 19 18 12 8 12 7 18 7 9
19 18 14 20 6 11 16 7 1 1 13 20 16 11 15 12 18 12 11 17 18 5 6 19 1 10 9 16 12 9 14 8 5 1 17 10 18 16 7 13 9 18 9 17 1 16 19 13 14 6 9 11 6 16 6 9
19 17 12 20 20 9 5 17 7 13 16 11 17 5 8 13 16 14 10 1 16 9 9 11 20 5 17 5 12 7 19 8 15 17 11 19 19 12 20 15 13 5 20 13 17 19 13 19 19 9 7 7 8 8 7 18
16 17 11 16 20 12 14 9 14 6 19 5 16 16 13 5 10 14 14 18 20 17 9 11 16 20 13 5 18 6 10 17 1 13 6 14 8 5 12 16 14 20 11 7 5 18 20 11 11 1 12 11 7 11 1 10
5 20 12 15 20 17 19 5 20 15 6 9 7 14 19 7 5 17 1 9 16 11 1 7 15 13 9 6 16 17 13 18 20 20 15 16 8 20 6 1 8 5 18 13 1 9 9 10 9 9 20 20 1 17 12 1
19 6 5 1 17 16 13 8 9 20 6 18 6 18 8 17 17 13 10 10 5 12 5 11 18 16 9 1 16 19 1 15 14 10 14 18 20 19 1 12 14 17 20 16 8 5 16 7 8 5 19 5 10 14 20 5
19 13 16 18 15 12 14 7 18 13 9 9 7 10 9 6 10 11 19 5 6 20 11 9 7 17 20 6 14 7 7 9 12 13 18 14 18 12 18 18 1 17 10 8 12 9 15 7 9 6 20 19 11 18 11 12
5 11 18 14 20 7 8 1 17 11 15 19 13 15 19 1 1 20 6 13 19 15 20 9 5 14 15 8 16 10 20 5 15 19 6 1 5 5 15 1 8 8 7 9 13 12 9 15 6 1 20 12 15 20 20 20
1 12 15 6 18 20 17 19 9 16 1 12 16 13 1 20 13 9 14 10 19 19 5 18 1 5 18 1 16 11 13 1 1 19 19 16 12 19 19 9 13 17 20 16 1 20 16 1 17 9 12 6 16 1 19 12
6 16 6 15 9 13 20 17 1 5 13 6 5 5 1 19 19 12 6 1 20 8 10 16 17 6 1 12 16 7 17 18 9 19 19 13 1 11 8 13 20 18 13 11 1 10 15 5 5 11 13 9 1 9 17 5
1 1 7 10 7 14 17 6 9 13 19 12 7 12 10 14 7 18 13 18 7 7 6 11 14 11 16 16 17 5 7 17 8 17 12 8 20 20 11 11 14 11 5 7 18 8 5 1 10 12 1 15 6 12 17 1
18 12 13 12 19 11 9 14 18 1 15 1 15 1 5 17 11 16 19 8 16 15 8 18 18 9 13 1 7 1 19 5 19 5 7 18 19 1 20 1 8 13 5 8 10 12 6 8 17 19 13 13 6 16 10 8
15 20 17 12 15 1 6 5 6 20 10 1 19 16 16 11 16 7 17 1 10 18 11 1 15 18 1 7 9 14 1 12 10 20 11 13 1 15 12 15 17 9 20 18 8 1 14 20 5 15 11 19 11 6 9 16
13 16 19 1 1 8 18 1 5 5 11 9 1 8 15 10 5 12 5 10 20 18 7 1 17 15 9 1 6 11 16 8 12 16 1 5 9 5 9 9 9 13 10 13 1 9 11 9 10 14 12 19 9 6 18 12
7 18 16 12 1 1 5 1 13 5 13 16 8 1 18 1 13 5 9 12 1 7 10 19 8 16 19 1 15 18 17 6 14 8 8 6 10 5 9 7 1 18 1 1 9 9 1 20 1 17 1 6 6 15 11 15
9 15 7 6 16 11 20 6 19 1 11 16 14 10 19 14 5 13 14 8 20 9 1 1 9 14 5 8 16 7 1 6 11 11 18 19 11 10 1 8 14 17 9 18 1 5 5 19 13 13 10 1 1 18 8 8
1 12 1 1 11 10 6 9 16 18 8 1 13 18 1 13 11 15 17 8 13 19 10 1 19 6 15 19 15 10 20 17 16 1 20 10 14 11 5 8 15 13 7 18 13 5 10 6 18 13 1 18 20 17 20 8
17 20 12 1 13 7 7 7 9 16 20 20 5 1 6 12 18 17 15 14 9 8 6 16 7 9 13 16 15 12 9 1 18 19 19 7 18 1 10 11 5 11 8 14 14 8 6 10 20 18 8 11 1 7 20 12
1 10 20 20 11 5 18 11 9 14 13 9 19 11 12 19 15 16 12 5 16 1 19 13 1 10 17 1 9 9 1 14 18 1 8 1 17 9 17 7 13 11 10 12 9 5 6 14 7 12 1 8 18 9 13 5
1 19 10 7 11 8 9 19 6 12 1 1 17 12 7 11 16 13 14 13 18 5 20 5 5 1 7 10 11 5 10 10 8 9 1 14 9 12 1 9 5 7 15 7 17 16 7 11 15 7 17 10 19 19 7 19
19 17 19 1 19 15 10 16 11 9 12 1 11 10 20 12 16 10 19 19 15 20 14 1 1 11 18 1 12 17 18 1 8 14 5 17 18 16 20 15 1 17 6 6 15 13 11 13 15 17 17 13 16 5 7 20
18 16 17 10 17 19 10 13 7 17 12 1 8 11 14 1 6 5 1 20 16 13 7 5 13 8 20 19 7 10 20 11 1 9 16 20 18 12 8 12 18 6 9 12 12 12 18 14 9 5 5 19 16 6 7 8
7 1 9 7 10 15 10 1 20 10 20 13 8 6 6 18 1 9 7 7 20 20 13 1 19 17 18 20 7 1 8 12 19 8 16 1 1 7 1 9 5 11 19 19 17 8 12 5 12 1 6 15 17 15 1 13
15 1 19 13 17 1 19 11 12 14 17 17 1 19 14 8 19 7 5 11 14 16 19 7 17 10 18 15 13 1 15 1 6 20 16 12 6 1 8 10 11 12 1 8 6 1 16 6 8 16 1 1 1 6 13 19
14 13 16 7 6 11 10 1 13 16 9 9 1 1 9 15 18 1 1 16 11 12 13 8 20 10 19 13 5 12 12 10 19 8 6 19 20 7 12 5 13 13 14 7 14 12 10 9 13 19 6 11 5 8 7 1
5 1 10 12 18 17 19 13 10 1 1 15 1 10 1 12 9 19 10 6 16 19 19 7 1 17 18 17 6 11 6 8 7 13 13 11 11 17 7 14 14 5 14 15 1 7 10 17 19 18 19 14 6 14 10 12
10 18 13 12 18 17 14 11 1 20 5 17 18 6 12 15 14 5 9 8 14 12 9 10 10 10 7 5 15 17 6 8 7 6 5 11 14 9 6 7 13 6 18 11 6 14 7 5 19 13 1 1 7 8 11 20
15 8 19 16 1 14 5 8 13 12 20 15 1 13 14 14 20 16 11 15 17 18 5 20 10 1 10 17 1 7 15 8 1 9 10 1 20 18 6 19 18 9 20 11 7 16 14 7 13 1 13 20 7 20 16 9
1 10 10 10 12 17 1 7 17 16 1 11 17 10 15 19 14 11 1 8 1 19 1 16 14 19 9 5 1 19 19 11 13 15 10 11 8 9 19 8 8 1 20 19 11 17 11 14 17 1 19 17 19 12 1 18
14 16 1 9 17 1 1 5 17 1 20 10 16 11 15 18 7 10 13 6 9 18 17 6 19 5 11 9 17 1 15 1 7 13 17 5 20 14 20 16 14 19 1 1 13 1 5 20 13 7 9 9 13 15 18 20
7 1 7 17 8 5 16 14 18 13 13 8 13 9 17 11 1 15 10 8 19 1 8 19 20 8 9 20 18 6 18 15 20 7 15 16 18 15 10 9 19 14 11 7 7 10 19 8 11 7 20 20 12 19 18 12
16 20 12 20 13 18 7 17 10 14 5 10 19 1 18 10 17 12 20 7 1 1 11 10 8 12 1 13 19 19 1 12 17 7 13 13 1 1 5 8 12 19 18 14 13 14 5 10 20 17 11 16 18 11 6 13
10 14 20 13 13 19 1 18 1 6 8 18 14 5 14 13 7 14 15 7 16 19 7 17 14 18 1 7 18 15 1 19 5 16 17 9 14 8 14 13 9 18 17 14 8 10 14 13 1 16 5 12 15 6 19 12
1 1 6 12 17 1 16 9 14 9 10 1 7 9 6 14 10 17 11 6 11 18 18 9 5 11 1 10 12 13 5 11 16 18 11 5 8 1 7 5 7 8 20 9 8 14 15 8 18 15 16 6 7 13 5 15
16 1 15 12 20 11 16 8 17 1 18 1 1 1 5 1 14 16 7 18 6 11 17 7 15 11 6 19 18 9 12 12 13 18 17 11 7 7 11 14 1 5 5 6 7 12 18 7 1 10 16 9 6 17 1 19
11 12 10 19 1 17 18 14 8 18 15 9 17 19 18 13 13 11 1 11 5 16 9 11 1 18 16 20 14 9 18 12 1 19 6 14 13 16 5 1 17 19 19 17 12 13 12 6 10 7 9 5 11 8 14 6
17 19 7 10 9 14 19 19 11 13 8 12 11 15 7 19 6 1 19 5 1 17 9 19 11 1 11 14 14 1 13 10 15 18 16 14 17 5 13 10 19 6 20 7 14 15 11 17 14 16 19 12 15 6 7 17
14 9 19 6 14 10 9 5 7 6 17 15 5 13 8 12 10 1 8 10 5 5 11 12 6 12 14 10 1 10 9 1 7 16 8 6 9 1 9 7 15 5 14 8 1 16 7 8 20 5 7 11 19 9 11 1
14 20 18 1 17 1 6 16 17 18 18 10 12 13 10 17 19 17 8 14 9 7 17 11 16 7 20 17 20 17 17 11 18 14 1 7 9 17 1 6 10 11 11 7 6 13 13 8 8 17 7 20 10 15 6 19
6 10 18 6 19 7 18 11 10 5 18 8 18 15 13 17 17 17 12 12 11 7 16 15 20 14 7 15 20 13 11 15 18 12 14 11 19 7 15 13 8 19 12 16 9 14 1 17 10 5 7 6 15 1 8 6
20 11 13 11 7 5 6 15 9 13 17 15 19 8 17 1 11 19 16 18 16 10 12 16 11 11 11 19 6 1 10 1 7 17 18 18 9 1 7 7 1 11 16 14 14 17 5 1 1 11 16 16 20 6 16 9
