22
1 4 10 16
22 30 41 1 2 36 45 5 21 40 1 16 1 30 1 1 33 1 1 12 14 46
24 1 3 36 12 42 40 25 33 1 50 46 11 45 1 14 28 16 26 40 25 1
1 2 34 1 6 13 23 37 23 10 36 20 37 3 15 42 45 37 43 6 11 26
27 34 26 19 1 20 37 1 9 1 40 44 1 41 1 1 1 26 7 1 1 1
21 32 10 29 13 27 44 34 1 22 22 22 42 1 16 35 36 4 11 23 29 1
1 36 11 20 1 44 46 11 12 1 39 1 42 41 6 3 17 10 45 42 46 8
45 26 12 37 18 1 1 32 32 50 12 27 1 1 47 31 1 47 1 1 18 17
45 1 8 36 39 24 28 2 5 43 7 46 49 42 4 38 31 48 1 12 21 30
47 1 35 36 1 25 44 48 1 1 14 6 7 7 23 8 34 12 1 13 41 35
1 1 19 1 1 24 26 6 36 43 17 44 27 1 4 43 21 10 12 41 2 31
19 1 36 40 8 1 35 25 41 48 35 47 1 48 18 1 33 44 35 1 1 1
34 25 14 8 1 19 7 28 4 7 1 28 1 36 34 3 10 28 43 39 1 1
13 1 1 10 40 32 24 24 2 1 40 2 44 1 30 17 38 16 48 36 1 12
5 1 45 46 17 34 23 1 23 22 1 10 20 46 1 1 32 39 46 18 1 23
50 1 6 29 36 22 48 1 40 48 30 10 7 41 46 1 30 1 23 9 28 20
5 42 47 33 13 11 3 1 26 24 5 42 46 1 42 11 50 9 45 29 22 22
44 1 44 1 5 1 1 12 40 50 4 7 34 43 47 10 50 7 19 14 1 47
40 50 1 20 14 18 1 33 1 29 32 20 1 1 1 27 3 1 13 49 10 49
14 12 34 34 5 45 3 29 32 1 1 1 20 44 33 41 11 6 19 38 46 34
39 1 38 31 3 41 30 39 18 37 28 1 43 1 44 1 16 10 23 29 15 1
1 1 26 1 45 12 19 7 7 27 1 3 32 7 1 10 35 8 1 11 4 6
30 21 46 49 1 7 11 3 1 9 1 6 4 26 22 30 35 29 1 46 36 36
