96
14 69 43 77
1 1 28 1 17 6 20 33 18 13 24 25 2 9 22 1 40 41 1 1 9 1 12 1 36 37 1 33 49 1 42 47 1 4 23 9 1 21 50 5 12 41 16 1 3 42 16 1 10 12 4 49 16 35 46 1 25 37 24 28 18 45 8 31 39 27 9 1 38 12 41 30 1 1 22 7 11 1 17 42 1 1 35 42 7 6 9 31 44 47 48 1 2 1 41 11
26 1 20 29 15 31 28 9 50 39 11 47 1 3 31 4 2 46 50 7 30 25 1 22 14 1 23 45 18 44 27 47 1 11 43 1 33 20 43 26 1 43 36 43 13 30 5 16 1 1 47 39 1 49 48 2 19 4 19 18 7 4 42 28 1 1 7 41 31 1 42 4 23 1 10 11 17 1 1 30 15 50 15 1 44 1 39 11 11 15 40 2 1 19 1 1
18 17 36 1 15 31 1 1 21 32 41 29 16 3 3 28 31 28 44 1 13 1 24 27 41 1 6 1 29 1 17 41 1 36 12 25 26 45 49 34 4 47 42 1 12 1 8 20 29 26 40 32 38 1 12 48 20 4 20 1 12 10 1 5 34 27 1 45 44 47 1 12 4 10 47 1 13 43 32 33 1 46 1 45 22 19 1 20 1 12 33 18 25 50 20 2
45 39 13 31 26 1 26 49 37 50 1 32 10 5 18 29 27 1 1 11 44 31 43 1 48 1 7 1 18 49 10 48 43 31 1 3 32 14 9 14 1 35 9 1 1 5 48 1 43 32 1 5 1 44 20 2 12 1 35 28 15 36 8 13 40 36 30 40 31 45 31 16 1 1 1 1 4 8 37 1 23 33 1 1 37 22 35 47 1 28 43 3 33 12 15 48
18 26 42 23 45 1 40 9 2 1 29 8 1 32 7 1 7 15 1 43 45 5 1 11 36 5 11 48 32 33 8 20 35 35 38 28 7 36 40 31 18 1 12 15 25 43 3 30 10 41 22 20 42 2 45 24 34 7 1 12 26 22 31 50 19 31 1 1 1 2 36 34 1 1 40 9 31 43 9 1 29 33 40 30 46 1 46 3 13 1 1 10 1 41 48 26
1 18 20 41 34 28 40 1 1 8 36 1 24 3 1 45 3 1 20 33 49 42 1 15 30 31 38 14 28 47 47 25 12 2 50 26 41 43 32 1 1 13 5 1 46 1 20 9 38 12 42 1 1 33 36 1 50 15 14 2 2 22 18 1 31 6 46 2 23 21 26 40 10 23 1 11 15 1 1 46 2 4 19 1 41 33 1 13 1 3 49 1 29 1 50 37
42 45 1 25 49 38 20 19 3 44 49 21 35 29 8 46 1 7 11 33 1 39 30 25 16 37 10 25 48 7 12 13 14 21 1 12 1 17 39 1 13 3 1 1 2 26 23 7 10 31 34 4 31 1 47 22 11 1 1 1 8 1 22 1 43 7 15 49 7 18 1 28 23 4 4 33 18 9 46 1 50 7 8 29 1 1 38 4 1 26 1 21 45 1 12 1
34 43 39 18 33 41 17 8 21 1 8 43 1 5 42 1 33 24 1 11 31 25 45 6 34 37 15 38 17 1 1 16 36 26 38 30 17 42 17 16 16 8 20 18 43 27 17 4 25 13 29 1 39 50 41 29 22 4 41 1 33 1 1 10 5 1 48 49 28 9 1 42 39 1 1 39 31 6 1 39 27 39 16 24 36 5 31 31 1 19 1 27 15 26 35 28
48 2 50 18 1 14 31 42 1 48 1 33 26 1 1 18 28 3 17 28 15 17 44 6 27 1 1 6 1 19 4 14 1 12 39 23 16 11 41 25 7 35 45 43 45 9 24 3 9 35 26 39 17 23 29 1 23 39 17 42 18 9 26 7 1 19 26 23 3 29 12 1 32 4 50 1 15 47 10 41 37 45 35 27 26 2 36 49 31 40 16 50 6 1 44 1
8 18 22 48 47 45 24 41 50 12 34 1 32 50 1 1 25 12 45 1 38 40 31 4 45 48 1 13 27 1 45 13 1 1 17 3 22 1 1 1 48 20 1 49 24 50 27 15 22 10 36 14 23 11 50 1 41 26 1 34 22 7 1 34 45 39 3 49 32 1 1 32 1 1 6 10 18 30 18 1 49 20 7 47 8 10 1 1 1 8 1 20 5 20 10 33
22 49 9 41 11 15 30 1 21 12 50 1 35 15 10 17 1 3 39 43 50 23 1 1 37 7 25 48 4 14 20 1 32 43 1 46 48 40 41 39 5 16 11 1 1 1 30 11 33 3 12 1 24 27 22 1 13 35 1 27 45 11 6 8 40 10 25 14 1 29 18 14 16 13 28 26 18 23 43 1 21 17 46 24 38 23 4 14 27 1 5 32 43 42 2 18
1 1 41 44 11 1 1 23 1 11 25 37 17 28 3 8 28 16 29 1 1 1 43 1 23 44 34 48 10 46 43 18 1 19 25 10 1 1 8 8 13 34 1 1 37 5 1 23 24 1 6 19 14 1 12 20 14 27 1 46 29 16 44 22 9 28 1 1 1 1 1 37 49 48 1 1 1 3 30 1 32 33 1 49 1 36 32 3 9 1 48 31 27 42 16 1
2 43 11 27 3 23 1 39 43 37 30 42 11 33 42 50 34 27 14 17 43 31 18 27 1 23 30 50 21 41 21 1 33 1 2 19 50 6 41 2 13 24 10 26 1 1 12 29 23 1 30 41 13 1 33 27 26 44 15 18 16 36 30 7 1 29 39 1 50 30 8 1 8 42 5 25 31 36 1 16 18 1 1 15 47 14 1 8 4 20 13 1 5 45 1 7
26 40 1 13 27 8 1 12 30 1 23 1 48 1 26 25 49 47 24 20 1 44 32 49 21 8 4 14 2 1 1 32 18 9 1 1 2 1 47 15 1 7 34 20 1 13 22 19 33 42 1 41 19 22 1 1 26 33 8 50 27 46 6 24 15 50 44 1 29 2 1 1 34 26 6 9 36 6 47 28 7 19 27 1 31 1 1 1 41 4 9 1 41 50 32 45
2 6 40 2 1 45 24 30 21 1 1 50 11 27 38 4 1 20 47 1 1 23 16 20 36 7 7 2 34 28 29 34 33 5 4 45 5 44 28 2 31 45 1 7 3 8 33 27 1 45 18 1 11 15 11 16 32 39 16 10 39 45 27 1 6 47 4 27 12 42 29 7 1 40 20 20 27 4 27 28 15 50 17 41 15 15 32 29 50 8 11 36 36 50 35 32
37 1 10 1 48 24 37 30 12 1 27 37 15 8 25 35 31 1 23 38 44 21 20 23 44 44 6 1 1 36 34 48 35 42 9 14 50 8 21 50 34 44 5 44 45 1 30 29 41 23 11 13 42 43 6 1 50 24 1 13 47 1 1 29 9 35 42 50 1 4 1 34 48 22 26 43 46 1 1 9 13 1 33 35 17 27 31 30 30 28 1 49 1 23 30 35
50 25 1 44 41 1 1 44 27 1 26 7 9 1 42 46 7 36 1 50 1 46 1 48 8 12 1 21 49 4 38 11 20 43 33 36 18 1 46 27 1 19 1 20 28 14 15 35 43 14 33 5 7 45 37 11 34 1 36 29 21 31 15 14 20 21 17 40 23 45 43 26 25 47 35 27 1 39 20 45 16 1 41 38 44 1 42 9 39 31 1 12 32 40 12 1
46 43 2 50 9 6 3 1 47 33 1 5 7 45 1 10 48 4 48 40 40 31 7 1 39 40 3 28 1 21 30 6 29 39 1 28 6 5 1 25 26 4 1 49 24 49 1 10 1 6 15 2 32 12 32 1 21 12 31 49 1 29 29 30 7 33 43 36 42 23 37 23 43 41 28 14 9 10 40 1 48 21 1 1 1 28 1 9 11 28 40 1 45 41 10 41
8 8 19 1 1 32 16 47 3 1 1 49 17 2 25 21 44 39 43 39 6 8 14 24 16 7 1 4 1 1 1 32 1 31 23 1 34 1 1 37 6 1 22 29 20 28 17 41 41 47 35 8 1 1 1 44 1 1 22 8 1 6 1 44 6 5 10 27 49 11 10 43 46 15 42 1 48 1 28 22 31 22 1 29 22 1 30 1 13 20 35 1 9 28 25 39
1 14 1 26 49 29 14 10 1 21 14 8 21 29 14 13 31 50 22 10 35 1 46 12 7 31 48 29 6 20 9 4 1 48 12 3 4 15 4 32 29 29 36 30 39 8 7 10 31 12 1 34 3 31 48 42 14 42 5 39 15 27 32 48 28 1 41 17 28 6 36 1 4 34 40 31 6 30 30 48 33 45 45 46 20 12 8 27 1 13 8 47 13 43 30 46
25 1 26 11 1 1 29 1 1 25 37 1 41 25 43 47 1 13 42 4 2 39 36 33 26 27 15 1 49 16 22 11 42 40 48 35 1 32 14 35 36 8 1 24 22 1 18 18 1 41 1 3 4 50 1 2 17 29 10 47 7 20 41 35 6 30 36 42 48 1 1 1 44 49 13 1 9 1 1 24 1 1 37 12 7 38 36 1 33 24 1 10 30 35 31 1
1 1 48 14 30 41 50 44 15 7 1 1 45 18 25 44 1 1 40 16 16 14 5 47 40 3 22 18 32 15 33 44 7 24 41 1 31 36 1 1 15 41 1 11 1 45 13 43 2 17 15 1 42 41 1 41 15 15 1 36 12 13 1 16 1 40 19 2 48 27 13 41 1 8 44 32 48 30 15 47 42 8 7 33 7 11 17 19 1 4 46 4 25 28 39 43
33 1 36 26 48 1 29 2 1 1 37 46 15 1 31 4 22 19 17 24 1 36 13 36 29 8 43 35 17 36 25 2 40 41 42 17 1 37 35 46 46 1 47 1 35 4 32 16 43 19 33 1 1 1 47 39 7 1 34 28 1 9 31 41 1 19 8 9 1 1 4 7 1 50 44 31 34 13 23 31 9 11 15 44 3 1 1 35 1 5 25 7 1 8 30 32
21 43 35 43 30 4 4 46 1 1 43 26 35 1 26 35 35 41 20 37 4 48 1 40 50 20 1 38 11 48 5 1 1 26 1 46 50 27 1 34 49 9 29 1 45 18 43 37 1 9 47 10 30 1 11 18 7 1 28 46 13 13 29 1 1 27 21 48 31 2 33 1 48 1 2 19 1 13 38 1 33 1 4 34 2 18 18 37 40 1 34 36 12 10 18 45
25 33 30 37 29 11 45 43 35 12 43 41 1 9 13 1 28 47 8 6 46 2 1 1 17 34 1 7 19 1 26 1 35 6 46 40 2 10 14 50 30 38 14 36 45 18 22 3 7 6 24 28 1 42 1 29 1 1 1 1 20 50 23 1 1 14 7 41 45 30 17 34 48 41 21 48 45 31 34 40 26 45 1 5 1 38 10 29 9 27 46 1 1 35 35 1
46 1 18 1 1 30 5 41 41 34 38 37 15 41 1 6 7 5 30 43 7 1 45 43 26 2 44 27 36 1 43 22 1 32 50 5 4 18 39 10 5 31 3 40 33 5 49 23 24 1 47 21 31 29 30 50 25 19 44 11 41 5 5 1 1 1 49 1 1 25 1 37 29 38 50 16 29 8 44 1 38 1 25 45 39 38 40 43 36 47 1 12 25 18 43 17
1 11 1 25 7 48 29 37 48 1 17 47 1 1 8 37 39 1 1 3 1 32 33 1 23 41 1 38 35 1 50 29 18 1 1 1 34 11 50 1 1 1 3 1 20 9 19 10 28 1 20 23 1 3 10 1 41 1 1 15 1 7 12 21 27 48 16 1 23 12 20 26 9 48 47 33 48 8 25 30 1 25 1 34 43 34 45 2 1 1 23 42 47 13 34 1
31 1 5 6 2 4 1 21 31 11 1 1 9 42 3 1 1 50 20 12 18 35 2 13 1 21 47 15 1 50 44 1 48 1 6 29 18 1 46 5 38 48 1 25 42 1 49 42 33 48 21 33 5 41 42 1 17 23 30 1 1 22 2 1 26 1 27 38 9 33 43 11 7 9 16 28 36 1 1 20 14 41 34 49 7 44 50 1 3 30 36 41 14 3 41 13
1 1 1 35 1 23 4 29 1 31 16 1 14 12 47 40 29 34 46 36 14 28 1 1 11 33 3 1 1 22 37 38 23 22 1 47 46 15 7 47 50 26 13 20 1 47 41 13 7 5 22 7 13 19 10 30 48 8 19 2 1 20 10 22 18 3 49 48 9 28 26 43 29 40 20 1 40 8 7 7 28 43 1 1 15 33 1 9 39 44 34 4 38 1 1 33
13 10 6 1 25 9 33 5 1 1 23 8 35 47 20 25 1 1 49 1 12 39 15 32 36 26 27 40 29 21 5 21 48 1 28 1 15 16 1 32 32 35 39 30 3 39 33 35 1 1 11 30 34 1 1 16 14 9 35 32 1 1 47 18 1 1 17 10 45 12 23 19 1 1 32 32 12 35 39 4 1 1 9 1 3 15 1 1 1 1 39 30 8 38 6 1
50 29 18 1 46 16 5 10 38 45 1 34 22 13 48 1 37 31 32 1 1 38 1 15 13 30 16 42 1 37 45 1 1 23 8 8 17 4 34 39 15 1 45 37 50 1 45 47 9 18 1 1 35 6 34 7 42 1 14 1 49 28 13 1 1 35 29 1 14 1 1 43 26 22 1 47 50 3 39 1 1 19 36 38 2 36 24 1 1 36 1 33 50 41 46 1
1 36 30 1 1 26 34 27 38 12 44 1 1 47 41 39 18 12 1 9 33 11 1 3 1 48 14 34 2 1 2 15 38 25 1 40 1 43 11 13 28 1 37 47 31 24 36 5 24 38 20 40 17 29 42 42 9 42 18 1 1 8 15 1 22 4 1 17 1 38 17 13 31 41 50 34 32 1 23 46 1 3 39 1 28 20 36 28 1 50 1 50 20 1 42 1
3 31 19 14 1 30 8 10 17 1 50 49 11 11 49 17 20 12 34 47 18 18 1 1 1 28 33 39 20 38 38 1 25 43 22 15 1 10 1 1 42 28 31 27 36 17 36 1 24 9 30 18 8 15 41 1 5 1 16 4 1 43 1 29 10 49 1 43 37 12 1 1 22 45 1 1 5 10 6 7 39 35 14 1 30 15 2 2 18 6 36 44 3 47 32 44
42 30 49 29 8 8 19 20 1 41 46 40 27 31 16 1 1 30 1 31 42 12 1 7 1 31 43 33 6 34 1 38 1 1 30 1 16 6 2 32 19 41 17 44 1 14 5 1 1 37 16 1 10 1 36 14 1 1 1 29 49 10 20 45 44 23 26 1 13 21 1 21 46 17 45 20 10 14 1 4 15 8 28 22 3 3 1 11 19 7 8 47 24 1 26 8
5 29 14 36 1 47 29 34 15 22 13 17 27 46 33 19 30 1 42 44 37 24 1 20 1 25 1 12 11 17 2 10 11 5 26 47 47 1 1 41 25 33 1 13 1 7 1 30 20 46 31 1 1 28 6 11 37 29 40 22 9 35 48 28 3 1 39 40 1 15 36 28 1 6 36 44 36 1 49 1 35 1 17 8 11 5 23 26 3 14 26 21 48 1 16 36
36 15 23 1 21 1 12 50 32 22 7 4 22 46 1 1 1 32 1 1 10 11 8 1 27 1 1 46 35 6 46 7 41 13 12 40 47 37 31 25 4 37 43 1 1 21 38 4 1 29 1 34 18 6 2 31 42 36 44 7 7 48 23 40 10 5 10 42 21 1 40 37 39 1 11 44 25 47 1 32 1 12 38 33 34 11 39 11 1 48 1 40 15 33 20 3
46 48 17 38 37 6 1 28 1 39 21 26 43 14 38 26 2 4 26 1 38 41 28 5 8 31 44 6 34 1 12 50 24 25 18 26 15 45 3 4 1 36 29 25 2 1 36 38 31 29 1 48 23 10 12 21 1 49 20 31 39 43 1 40 3 44 29 26 1 2 44 4 16 10 11 35 28 44 46 6 33 42 35 26 41 30 29 3 1 18 19 46 24 44 16 42
28 42 5 13 1 27 1 20 22 34 1 40 1 29 2 44 1 24 22 22 24 35 1 17 1 12 2 1 37 12 36 23 18 16 44 13 1 1 12 44 1 32 1 50 34 33 18 36 16 43 37 1 50 18 1 35 14 46 20 1 19 41 1 5 25 16 1 1 45 15 29 22 45 37 28 24 33 13 32 24 29 1 1 11 25 24 19 1 1 27 42 33 1 28 1 1
1 11 1 39 19 44 43 45 22 33 34 15 30 29 32 11 14 48 35 14 1 2 1 44 33 8 36 1 1 23 37 49 23 38 1 8 34 1 47 1 4 28 18 10 44 18 38 1 25 4 43 40 39 1 50 18 22 41 1 42 11 7 49 46 44 28 22 3 21 1 1 14 11 8 17 28 5 7 14 23 7 41 40 1 1 1 37 38 25 9 1 16 28 1 46 1
25 29 2 40 33 19 4 43 32 24 28 26 13 1 5 27 1 14 20 50 1 43 1 36 24 8 44 33 32 21 31 50 29 40 24 1 21 22 16 1 20 26 2 25 42 13 1 4 30 1 16 2 2 13 30 43 1 20 1 40 4 40 1 1 1 1 27 35 1 7 8 1 1 27 2 40 37 1 1 1 14 31 49 24 16 13 5 46 27 34 34 22 45 33 38 40
17 39 1 48 11 3 34 19 7 2 1 1 49 34 33 26 5 3 15 33 42 50 1 1 13 27 1 49 7 28 3 25 30 10 45 1 7 1 22 3 1 23 10 23 1 38 7 1 45 49 50 34 22 13 1 26 41 49 1 1 24 7 8 1 6 17 49 46 1 6 17 1 1 16 1 5 49 1 21 44 1 44 15 1 11 3 33 49 25 7 30 17 42 38 48 31
16 6 39 7 4 46 6 35 49 46 46 44 32 32 3 17 40 1 8 1 3 1 45 1 11 1 50 13 1 1 3 29 3 1 14 41 32 47 10 7 20 22 34 7 40 1 6 17 30 12 1 1 17 40 30 35 19 28 1 9 14 40 1 37 26 5 25 13 6 21 16 1 20 1 37 21 11 15 11 1 32 43 1 45 38 16 27 1 28 26 12 31 26 48 24 7
24 35 29 37 41 15 1 12 1 4 18 3 27 28 2 1 5 28 28 38 23 46 2 16 11 11 31 47 11 1 25 30 45 42 10 15 29 42 37 25 40 27 1 1 1 17 43 10 1 1 42 1 50 1 16 35 8 49 14 14 8 48 28 31 46 13 44 19 31 21 1 9 1 1 13 6 1 1 14 45 13 27 1 9 1 1 41 11 1 16 1 32 41 46 46 1
47 1 26 27 11 11 21 19 49 20 19 22 7 30 24 36 38 20 27 32 1 8 1 23 46 1 40 26 17 19 21 1 39 1 8 1 1 11 41 23 1 26 1 35 5 6 42 1 46 50 36 14 26 32 8 1 1 28 32 15 30 6 49 1 34 36 18 45 32 28 1 1 1 47 20 3 1 32 32 47 31 29 42 1 32 23 45 25 1 33 38 41 29 8 27 11
2 1 43 1 1 22 7 1 39 33 33 22 33 47 1 1 17 36 30 32 12 1 1 49 1 31 20 41 14 13 10 26 1 12 23 39 4 32 10 1 42 22 4 32 7 1 33 50 38 1 1 34 21 1 19 1 13 38 15 50 39 1 41 8 26 31 50 40 9 34 19 1 41 1 10 1 1 27 20 17 47 11 38 1 32 23 1 42 44 1 1 7 50 1 1 50
29 14 30 36 37 5 50 1 36 17 8 1 24 1 12 1 28 23 1 1 43 35 33 46 32 40 1 8 23 17 1 24 43 3 35 25 25 1 41 1 1 3 29 33 1 1 45 1 29 35 6 13 44 8 25 37 1 1 45 1 31 1 5 36 47 1 47 1 1 41 8 1 37 36 33 22 18 25 14 47 17 35 9 1 41 16 37 15 1 50 6 1 1 48 35 47
48 50 6 34 49 38 44 34 9 1 39 36 34 1 22 28 30 1 14 7 20 2 35 25 1 7 24 4 1 17 1 1 5 7 40 2 29 13 27 1 29 21 40 11 1 46 44 24 19 18 1 6 38 1 42 21 39 28 1 25 22 14 24 35 38 33 8 15 32 6 15 50 11 1 50 2 40 2 2 1 38 29 1 21 1 27 37 1 30 26 44 49 9 29 22 1
45 48 3 1 40 1 48 1 17 1 45 22 17 41 25 14 40 7 11 33 7 38 35 12 4 49 3 1 24 1 1 39 14 36 34 27 25 19 24 1 1 45 21 23 50 27 1 20 6 22 5 1 1 12 29 4 37 6 24 1 46 1 44 5 19 15 42 5 26 4 1 4 37 22 9 35 50 38 6 1 31 39 20 26 1 2 35 29 41 28 1 1 27 23 1 1
18 36 9 15 14 43 12 1 1 8 45 15 35 12 30 49 27 1 35 20 1 1 21 29 1 28 43 20 25 4 38 40 36 1 22 38 48 3 47 44 38 26 25 31 38 21 9 18 9 30 11 24 1 1 39 14 43 1 5 1 10 34 18 17 20 1 50 9 37 1 29 33 1 7 20 42 6 1 45 44 1 19 16 46 1 1 41 9 1 21 1 27 47 17 2 47
44 1 32 4 1 19 44 6 12 1 28 3 39 1 17 28 43 1 19 44 34 1 18 18 23 32 50 9 5 27 16 20 24 1 6 34 33 1 1 34 9 13 3 17 49 40 30 1 2 42 46 1 1 50 47 1 30 36 44 17 21 18 33 36 9 1 1 1 49 25 13 21 1 48 1 1 46 1 1 39 1 21 47 42 36 38 1 34 31 1 45 47 30 42 1 17
13 20 1 43 38 1 50 7 47 25 25 26 5 40 42 39 1 25 1 29 48 9 42 42 1 22 17 20 50 5 42 35 1 29 12 33 6 1 26 1 35 37 36 2 39 23 43 11 7 1 43 31 1 1 10 14 6 48 1 1 3 35 17 4 14 31 2 31 47 1 23 24 6 24 28 1 17 2 41 33 31 23 1 1 18 5 31 1 11 48 1 15 1 1 16 34
1 6 19 1 1 1 47 37 5 1 39 25 6 12 1 16 38 24 23 27 9 13 42 31 13 38 1 17 1 11 21 1 16 11 1 1 1 8 22 4 1 9 23 1 12 1 12 38 19 1 23 46 6 34 23 50 50 26 5 1 1 14 45 41 32 11 1 28 2 24 8 37 11 18 15 27 6 16 49 1 19 39 40 40 12 1 3 28 38 1 7 26 50 3 1 6
46 2 46 44 11 13 24 1 31 11 44 45 11 24 20 38 23 7 6 40 4 34 33 13 20 29 25 39 1 9 15 42 44 39 30 37 1 14 28 1 25 1 1 1 16 1 6 18 42 9 1 19 15 31 1 6 1 47 14 14 1 25 37 45 1 1 46 31 6 29 5 30 20 44 20 46 31 40 22 15 36 14 1 1 34 28 1 10 1 25 38 10 1 4 1 24
1 1 3 40 22 1 1 28 6 9 37 30 1 50 19 26 22 35 35 34 25 28 33 45 11 50 1 1 33 16 1 36 39 44 6 10 32 1 27 16 7 10 15 1 42 1 26 43 16 32 1 47 1 1 39 16 49 49 1 1 1 49 29 34 18 48 30 34 31 31 1 38 1 38 1 41 30 1 12 17 24 1 1 33 38 1 27 50 4 15 44 1 16 1 38 23
28 24 14 23 42 19 16 10 22 19 1 7 14 10 19 44 1 15 4 1 24 1 19 48 1 31 20 1 15 11 10 46 25 34 1 43 1 45 43 36 4 35 1 48 1 1 1 1 5 1 34 33 4 50 7 1 12 25 13 1 2 1 1 1 19 46 2 1 45 1 25 22 8 5 44 4 45 11 33 50 46 25 1 17 40 1 26 45 35 1 30 49 38 21 27 1
1 9 48 28 12 1 22 49 1 10 1 16 21 1 33 14 50 26 1 14 1 17 32 27 15 44 1 42 14 22 13 15 6 23 40 45 33 5 31 12 17 38 48 1 49 21 40 26 1 17 1 1 3 42 1 1 1 18 16 37 6 43 25 12 47 38 31 41 1 10 21 1 4 43 43 6 1 5 35 17 1 1 1 24 29 40 47 47 22 41 15 17 6 1 1 24
8 27 48 5 43 33 39 5 3 29 1 1 37 11 1 17 39 1 1 50 45 1 1 17 1 24 17 45 2 36 3 42 37 34 26 1 43 4 45 20 44 41 38 36 2 41 39 18 24 45 28 1 39 4 45 1 1 8 6 1 25 1 9 1 19 42 39 36 4 1 47 22 44 1 43 19 47 35 10 23 48 36 3 3 1 1 4 46 43 21 35 33 48 26 2 6
27 1 1 4 11 8 26 39 18 46 5 13 1 1 42 17 1 13 1 37 36 50 24 6 29 7 44 18 46 35 1 6 37 26 43 1 15 3 1 1 10 32 19 37 23 1 50 39 37 7 1 1 15 1 6 36 38 6 1 37 32 1 45 5 1 46 39 1 19 4 41 45 43 1 6 1 6 43 1 16 1 14 48 1 41 28 15 2 1 1 36 11 36 8 1 23
1 21 34 23 45 1 44 39 40 10 3 8 14 1 31 20 49 50 26 5 44 36 1 41 10 39 47 1 40 35 46 23 43 24 49 43 5 1 10 1 1 15 42 25 5 32 28 5 47 4 42 11 16 2 39 1 1 15 27 2 23 23 47 1 22 1 9 47 2 1 32 1 16 43 12 1 47 26 1 1 47 1 1 1 35 11 20 45 44 1 41 43 38 31 36 1
29 14 1 43 11 6 15 8 1 1 27 40 50 45 32 1 18 2 2 7 24 5 17 30 4 15 11 4 2 35 19 22 15 12 46 6 14 1 27 49 36 1 28 1 35 42 28 19 47 27 1 28 16 1 1 1 1 10 22 1 50 1 7 35 22 1 1 2 47 9 10 24 1 1 10 6 1 28 1 22 1 43 46 47 29 18 6 23 27 48 21 17 48 1 1 37
4 1 26 13 19 39 11 43 2 7 8 30 50 19 10 1 48 2 1 1 6 30 48 19 26 34 25 43 48 24 13 27 27 1 26 1 17 42 26 17 33 26 35 11 1 1 3 50 4 17 21 26 12 39 4 18 19 26 1 35 25 23 5 1 9 11 27 1 1 1 27 10 1 1 31 21 9 18 42 4 37 1 20 35 45 26 7 11 1 1 7 49 1 3 17 8
22 8 38 20 1 1 37 16 8 3 6 13 1 18 41 9 3 1 25 41 20 35 37 48 1 24 45 6 20 11 31 3 24 25 29 22 1 18 30 7 1 27 5 42 21 1 23 1 1 1 27 28 17 7 17 10 26 1 1 10 10 5 1 1 1 48 21 28 19 39 44 1 39 40 48 1 18 5 49 3 48 1 48 36 9 48 38 1 45 1 1 40 25 45 26 47
41 7 30 39 27 12 8 23 1 18 36 6 16 49 34 11 1 17 1 26 36 48 1 16 43 39 1 6 26 1 1 35 44 20 41 41 37 2 1 37 10 28 26 5 40 1 42 50 37 1 48 1 1 1 23 4 44 20 10 9 16 33 31 4 31 1 28 15 1 1 1 34 40 1 11 39 1 45 24 1 46 38 36 35 16 27 37 10 41 41 41 43 31 1 1 2
49 43 4 50 24 38 32 1 8 1 22 50 33 5 10 41 9 14 49 1 1 40 12 40 48 15 15 44 3 44 19 36 9 14 46 12 11 10 33 1 37 25 11 14 15 43 42 5 50 28 42 41 1 1 1 36 41 1 1 21 29 20 1 39 5 4 13 1 41 47 24 40 24 25 33 1 44 20 1 3 1 42 32 1 19 42 10 5 35 1 13 45 20 33 49 12
1 24 38 40 39 38 23 17 50 1 30 8 16 4 1 43 1 41 9 15 11 35 24 14 39 30 1 1 1 1 1 24 18 35 47 23 47 38 42 1 41 1 47 43 5 49 42 4 37 43 1 26 49 34 27 1 1 47 2 4 39 1 37 45 1 46 49 48 36 1 28 3 1 42 24 15 15 35 15 32 6 32 1 46 37 46 49 38 29 7 34 44 29 1 1 1
1 38 40 39 47 8 20 26 6 10 18 8 1 32 1 48 19 22 29 34 49 19 18 1 13 41 6 1 31 31 15 24 15 42 23 38 1 1 2 1 1 6 45 14 6 1 14 16 1 28 37 41 1 1 18 45 40 42 24 13 43 23 10 28 10 11 1 24 1 5 38 6 49 40 48 25 8 46 39 34 30 1 13 32 32 43 1 1 24 1 1 1 50 20 1 40
1 26 1 1 21 19 5 11 1 48 21 50 29 50 1 33 1 26 27 20 5 39 41 1 1 1 1 44 4 1 1 12 46 1 6 46 36 18 40 30 1 16 15 1 1 28 31 49 10 14 9 38 1 48 37 41 1 1 19 22 8 1 18 48 1 1 1 5 1 41 7 48 1 16 50 1 1 22 1 25 44 32 12 39 25 39 20 31 1 26 20 47 37 39 7 16
6 34 42 1 1 18 3 1 10 29 40 41 3 1 1 5 17 1 36 1 32 13 21 26 2 9 13 1 10 7 8 23 15 1 48 16 48 29 24 46 1 27 25 40 41 3 1 1 26 25 1 50 24 15 15 1 2 32 7 33 49 43 36 1 40 1 35 42 4 46 32 14 1 18 46 28 11 11 37 32 46 1 47 17 50 1 21 10 16 4 1 32 34 27 24 1
35 8 45 32 12 5 1 19 1 1 4 1 45 1 37 16 1 1 1 10 15 46 42 37 21 1 25 43 32 41 1 4 43 37 10 1 37 25 32 1 8 13 1 1 35 24 11 19 4 12 5 1 50 1 49 10 5 36 35 33 47 5 13 21 17 42 1 49 25 11 4 1 40 39 28 23 16 17 2 2 5 32 42 7 50 48 2 35 1 31 12 28 27 2 1 20
27 1 17 1 37 19 19 23 1 48 1 19 1 5 1 35 36 1 30 1 1 1 33 41 44 24 3 35 37 45 37 9 1 10 19 2 31 1 17 1 21 37 24 15 15 23 39 1 42 37 9 1 4 11 40 17 19 19 1 38 44 23 21 1 1 15 31 22 1 9 28 23 19 38 5 1 31 1 1 39 31 24 50 39 28 11 32 14 17 34 33 1 39 3 39 1
13 41 1 4 12 43 40 21 15 30 46 22 50 1 8 1 1 1 23 40 9 17 41 15 8 30 1 34 50 24 5 1 44 21 45 1 11 1 34 14 1 1 1 8 41 20 41 41 1 1 35 49 32 42 1 48 37 8 1 1 1 39 30 25 26 35 2 15 39 30 41 1 38 35 32 1 2 45 1 35 12 9 1 33 6 46 1 13 15 44 1 5 7 1 19 9
33 38 30 46 8 42 12 1 29 16 1 32 1 1 4 6 16 47 35 25 1 41 41 1 3 27 33 38 39 28 41 39 25 24 45 40 26 15 19 1 19 1 2 1 8 1 1 16 10 10 12 19 23 41 1 28 1 1 1 23 1 1 8 31 1 34 1 28 1 1 25 1 24 9 49 6 50 33 45 27 39 44 11 40 42 47 28 17 1 40 45 34 27 44 20 16
43 22 7 1 1 35 1 32 30 1 1 1 10 12 25 37 24 16 24 45 13 42 26 39 50 19 11 48 1 45 23 1 16 27 37 1 38 24 7 1 21 11 1 3 43 46 1 11 12 36 1 1 8 48 19 14 38 50 25 16 46 45 45 31 23 41 38 30 13 9 32 1 7 47 1 1 10 35 45 29 32 16 19 14 1 1 21 36 45 32 24 1 1 1 21 48
32 9 12 6 42 3 1 5 12 3 44 2 31 50 23 39 9 46 12 6 12 35 1 13 21 21 1 1 17 23 17 50 32 42 1 43 1 1 1 1 1 1 18 21 1 30 10 23 20 19 34 45 20 16 4 1 34 1 40 7 30 35 1 47 1 45 24 29 4 23 1 1 1 7 1 1 41 39 1 36 34 12 21 3 22 1 1 1 9 13 1 39 26 1 11 29
43 40 48 1 6 48 35 43 1 28 1 20 22 9 38 44 29 1 49 29 23 7 1 47 47 29 11 1 1 35 8 1 19 1 9 44 7 35 44 22 1 33 10 24 45 1 41 20 3 4 1 1 30 1 12 41 13 9 38 11 39 28 50 7 1 32 13 31 42 34 42 15 37 19 20 39 10 1 30 29 1 8 4 20 1 30 34 7 1 6 15 29 29 1 1 1
14 31 40 1 1 28 25 42 17 15 2 32 1 23 22 40 23 38 27 32 1 1 41 48 1 21 16 37 40 28 31 33 44 9 1 29 50 14 34 35 34 46 42 43 1 22 40 1 1 13 12 44 1 6 41 27 5 21 47 18 25 28 36 1 6 16 11 22 46 28 44 34 43 17 18 12 8 7 1 27 23 1 29 36 1 40 49 35 21 11 45 9 1 1 39 23
14 1 43 1 50 1 50 22 1 45 38 4 2 30 15 1 9 40 5 1 1 18 45 36 22 15 11 8 28 17 4 2 7 23 32 3 11 38 28 34 1 1 6 8 50 1 21 36 29 37 43 1 1 21 35 43 13 31 9 36 6 1 18 28 40 1 1 20 5 15 20 49 26 45 41 48 4 46 1 11 34 1 37 7 34 15 32 12 12 1 32 32 2 31 10 25
25 19 25 48 6 6 2 38 47 13 50 21 12 38 37 44 8 32 1 33 21 6 1 34 50 24 1 35 46 3 1 7 36 10 49 1 34 1 28 22 48 24 9 1 8 31 34 1 41 1 1 1 10 46 42 46 1 32 6 44 1 13 39 18 30 1 50 45 1 4 16 20 11 30 7 19 34 38 21 1 1 1 37 1 17 7 1 33 37 28 16 24 20 22 21 17
14 6 29 1 4 49 1 1 47 21 34 49 1 2 22 2 1 21 23 9 1 22 49 1 23 18 1 1 1 17 39 40 43 7 36 48 26 1 1 35 41 34 7 21 48 46 1 38 29 1 36 1 1 36 15 5 38 32 28 36 45 25 1 26 7 3 23 43 18 30 18 42 41 9 6 13 35 1 23 1 1 22 3 13 43 19 7 43 37 45 1 12 1 35 31 41
21 6 1 1 18 20 40 6 2 5 17 7 8 48 18 1 10 41 41 27 37 50 38 27 33 32 42 27 30 1 50 48 18 41 1 6 23 22 2 38 4 7 1 1 19 1 1 1 46 25 31 48 16 18 28 42 10 32 41 23 1 23 1 44 8 1 46 31 1 2 40 25 1 6 1 50 31 9 42 1 30 1 30 50 46 24 7 24 2 1 17 38 41 21 50 39
1 19 18 12 10 47 26 29 24 22 20 1 17 1 26 35 1 38 23 18 40 1 1 38 4 1 11 25 20 1 14 35 20 1 38 1 50 33 42 1 46 29 11 45 47 42 34 6 8 37 44 10 11 12 38 49 1 4 47 1 20 7 1 2 47 1 3 1 1 27 22 25 1 13 1 28 30 1 24 2 1 5 45 1 5 1 33 41 14 32 41 12 9 1 19 31
35 36 15 1 17 22 1 45 16 20 1 29 48 32 1 15 8 42 24 42 44 26 29 36 1 7 13 42 7 21 46 28 24 9 36 37 49 1 24 1 16 7 1 18 7 43 1 38 46 8 15 39 36 48 41 14 16 1 31 1 10 11 9 32 13 46 48 1 7 16 1 12 1 50 33 29 1 21 1 6 39 7 15 20 49 45 1 1 27 1 1 11 20 42 29 1
8 12 47 25 10 1 1 1 1 1 6 2 26 39 47 15 20 18 43 14 10 16 38 12 1 23 1 12 37 1 42 41 21 4 25 39 11 1 42 39 25 1 46 39 48 31 43 44 22 14 1 43 46 35 36 1 1 30 12 33 22 30 31 8 1 1 1 14 39 38 14 18 12 10 13 15 16 44 38 7 24 43 4 48 40 46 6 11 43 7 39 17 33 21 3 41
19 23 1 1 1 1 31 18 30 45 15 19 28 1 1 3 22 1 1 19 22 33 10 1 1 34 48 42 1 11 1 22 3 27 18 36 33 1 13 44 3 42 16 46 38 27 18 1 1 1 18 1 1 9 15 22 42 45 32 16 49 1 20 25 29 22 1 9 46 1 50 13 5 48 1 46 40 8 49 43 1 1 1 1 40 1 8 36 1 5 44 9 34 33 34 33
3 32 19 5 1 1 44 15 1 27 6 24 45 38 14 42 44 16 48 37 29 48 22 43 20 49 1 45 48 20 42 45 16 20 1 1 15 37 1 1 24 16 1 23 23 41 10 17 30 45 43 11 46 50 48 10 42 1 39 3 37 45 22 32 16 14 50 22 50 49 1 3 11 26 19 12 5 25 50 1 14 1 35 6 46 5 12 37 35 19 1 18 25 18 29 50
1 33 3 10 2 14 33 24 22 1 41 47 11 30 1 5 23 1 20 50 7 1 21 28 23 1 29 1 50 46 25 8 1 35 13 40 4 43 1 50 26 35 43 11 1 1 1 43 27 14 1 39 21 16 26 8 30 1 1 33 1 36 45 1 34 39 1 1 1 6 24 41 24 23 1 7 9 47 19 12 7 1 35 10 31 19 29 38 21 1 12 50 9 2 8 31
48 30 1 35 48 12 48 8 11 44 15 20 2 24 18 35 11 25 22 1 19 39 5 13 46 37 39 5 1 50 21 16 18 6 19 4 2 23 26 1 40 43 44 10 1 26 16 34 1 35 41 4 1 1 27 8 19 2 47 1 41 17 25 6 2 1 12 24 25 1 2 29 3 26 19 13 1 26 26 1 39 1 49 25 45 34 17 46 49 1 3 2 11 35 11 49
37 7 31 49 32 1 47 44 50 21 1 39 1 20 1 1 1 43 36 27 1 1 3 7 1 9 25 20 23 6 45 29 49 21 22 29 14 13 49 1 5 8 33 1 18 24 1 29 1 1 1 22 17 31 1 1 1 9 35 47 11 2 47 18 1 1 41 29 32 31 48 12 44 11 14 32 26 6 25 5 12 1 26 34 32 29 9 1 1 33 1 5 39 43 23 10
7 19 19 37 40 47 41 28 27 21 49 20 24 33 1 1 9 10 19 16 1 1 1 1 1 44 12 6 10 46 38 18 8 1 32 23 34 1 27 21 30 1 23 43 28 1 27 41 41 1 21 23 1 1 38 38 45 47 15 24 19 1 1 33 1 26 14 18 42 15 47 31 42 1 48 11 1 47 32 19 9 1 28 6 28 21 34 1 1 17 26 24 1 45 22 1
20 4 1 12 21 23 7 49 25 42 1 35 1 19 9 8 1 45 4 1 30 37 27 2 24 26 1 48 1 11 3 1 13 22 1 38 1 42 16 5 34 21 1 6 22 21 28 10 20 1 2 8 1 49 16 2 19 1 20 1 13 40 10 5 24 1 2 34 42 39 8 35 43 28 34 8 50 22 11 1 19 1 48 13 15 12 16 27 1 7 42 37 1 29 1 14
37 29 42 1 4 1 43 23 1 26 1 1 29 1 23 4 39 38 2 10 21 13 1 13 37 22 9 21 37 20 43 30 49 1 36 32 36 1 42 49 20 16 2 1 37 35 20 19 5 36 44 33 1 11 7 1 40 1 34 10 31 41 1 23 1 1 18 7 32 21 12 11 49 6 11 30 41 50 1 45 25 37 9 1 47 15 14 44 26 28 1 1 38 32 1 25
20 5 3 1 13 1 43 4 1 44 4 9 1 13 1 1 36 4 8 39 27 11 2 30 27 12 3 27 1 26 1 8 15 25 11 17 10 1 9 26 33 34 50 1 43 16 47 30 50 22 12 1 23 45 35 1 18 1 19 43 1 1 45 40 13 1 1 7 31 1 8 20 28 1 3 1 37 40 23 1 22 30 1 1 18 31 26 19 31 41 11 1 1 22 35 42
22 30 31 11 42 1 31 41 29 13 33 34 1 15 31 1 41 21 21 47 1 1 30 24 36 1 1 10 1 1 1 50 9 5 8 29 23 29 1 1 39 27 17 42 17 40 44 1 26 11 1 1 4 8 1 7 10 8 15 6 29 30 27 48 1 38 32 8 22 1 1 1 6 33 49 15 1 38 29 47 4 15 28 35 11 30 36 27 1 1 49 15 36 2 36 45
45 36 17 14 18 37 5 35 1 11 49 1 40 49 27 36 31 8 49 39 1 20 32 40 13 1 17 31 4 47 2 15 14 41 4 1 21 44 10 26 10 49 1 1 42 21 19 29 1 40 10 46 13 49 17 24 20 28 1 1 6 1 12 26 1 17 35 9 1 49 15 3 15 40 48 15 25 23 11 1 1 1 1 1 47 1 13 49 23 5 8 1 1 1 1 12
1 44 2 34 22 16 4 16 1 39 1 1 3 1 43 48 24 45 22 32 11 9 10 48 48 20 16 1 39 30 32 6 38 1 4 17 27 6 1 1 1 44 1 1 35 1 45 1 31 1 19 18 17 36 36 6 45 1 9 44 47 31 17 50 1 4 42 7 46 1 1 1 32 36 45 30 33 20 11 44 5 17 27 44 46 47 1 7 21 1 36 1 1 24 39 32
42 5 33 48 1 31 4 21 20 36 37 1 11 1 22 32 44 9 38 1 1 50 35 6 22 21 31 46 14 1 42 16 17 1 23 5 37 46 24 43 47 18 1 19 7 16 15 5 43 50 32 45 1 47 20 27 47 12 5 34 1 44 11 34 39 42 41 2 12 48 28 41 17 37 35 1 16 4 18 31 26 47 24 1 31 23 17 1 2 1 8 28 1 13 38 1
