87
43 26 44 80
48 1 1 21 40 44 1 36 36 8 1 33 18 12 32 11 1 3 14 12 33 16 17 1 13 9 44 1 47 7 1 1 1 18 1 9 15 25 28 46 5 5 23 20 18 21 33 1 23 44 24 1 16 32 29 1 1 36 48 5 27 4 13 44 49 29 41 15 31 8 38 44 11 28 4 26 9 29 1 8 47 1 28 1 47 32 5
9 22 2 48 15 40 41 1 43 42 6 30 27 1 31 1 34 46 8 46 44 4 1 1 2 23 35 14 3 48 25 21 15 3 50 49 25 1 34 1 6 29 26 13 21 47 25 1 1 48 1 20 41 44 1 23 12 7 16 1 29 19 44 21 23 30 1 33 11 1 40 1 12 35 21 31 10 39 4 41 11 46 50 1 11 8 23
27 45 45 32 26 46 40 48 1 1 9 11 44 30 31 14 13 46 8 19 20 1 10 15 38 1 35 35 34 31 31 14 33 26 12 5 33 28 5 4 6 46 50 43 24 50 1 28 40 1 40 34 20 24 45 31 30 1 43 35 34 27 19 42 26 40 43 1 11 31 13 12 41 7 30 40 47 18 8 49 1 50 29 7 32 26 46
46 1 4 45 1 13 42 9 21 30 1 35 49 31 15 1 1 50 1 21 46 1 36 11 50 1 42 26 33 1 4 41 1 43 13 31 12 33 16 35 13 3 48 50 7 31 27 12 27 25 45 39 34 16 1 41 17 1 1 1 46 13 41 28 34 34 37 40 12 11 17 7 7 31 1 1 31 13 7 16 13 1 35 1 1 18 27
19 23 34 6 19 1 21 47 47 31 30 1 22 46 8 35 16 24 3 11 15 11 28 13 36 44 7 26 39 1 37 21 35 6 1 4 50 25 14 35 1 41 1 39 44 42 13 11 34 1 40 2 25 48 49 35 16 1 38 17 1 49 46 13 47 28 31 10 23 26 1 46 18 16 37 1 15 1 1 33 30 10 1 18 30 44 48
47 3 22 6 49 18 33 28 29 7 28 4 37 1 49 48 9 45 46 45 13 24 1 28 46 19 1 39 42 1 24 50 5 26 27 21 37 2 7 8 13 34 33 36 41 8 37 42 36 34 15 6 12 1 34 45 13 34 14 19 42 3 41 1 38 5 2 1 10 37 23 30 27 50 35 46 39 4 1 16 36 16 1 47 14 8 50
49 9 41 16 1 1 23 25 37 7 21 33 8 1 9 32 35 43 48 1 25 47 23 50 12 41 41 28 11 11 6 18 47 39 34 1 9 48 5 1 1 20 21 5 2 1 41 9 1 9 24 1 17 1 1 27 9 49 1 36 1 25 1 13 49 32 36 27 38 10 13 10 6 15 45 16 1 1 28 4 23 50 22 2 37 6 1
1 5 46 46 9 44 1 1 12 8 50 37 1 27 1 43 1 23 20 3 1 49 1 16 33 21 29 32 14 49 35 43 3 37 28 37 2 39 22 10 1 22 48 47 49 19 1 1 1 30 46 20 50 1 1 2 45 45 41 16 36 1 17 45 11 25 20 2 49 1 13 43 3 17 46 15 1 45 1 7 20 1 15 17 1 20 1
1 12 38 43 20 37 1 20 29 39 21 31 35 16 5 45 34 48 2 12 1 28 23 1 43 21 44 27 24 49 1 43 1 26 25 15 40 3 1 46 39 35 1 1 1 20 1 32 23 22 25 47 13 1 33 30 45 35 50 29 34 1 13 5 35 1 27 47 1 1 29 9 10 46 12 48 1 15 28 1 13 1 33 44 24 1 35
13 35 31 21 15 22 32 1 37 20 22 44 7 1 4 14 48 1 22 50 34 28 32 15 1 27 6 17 38 17 1 1 47 50 18 1 11 1 34 6 2 3 26 17 48 8 42 48 1 30 11 1 2 26 1 31 1 13 43 2 7 5 37 2 1 1 1 6 34 42 35 17 1 45 27 14 20 6 43 1 1 1 12 28 20 17 12
33 37 47 22 39 1 46 49 9 33 26 21 7 28 29 42 17 2 40 24 39 1 39 1 1 31 47 13 39 1 12 50 1 41 49 32 22 5 1 26 14 30 18 47 1 34 17 9 8 23 1 14 1 1 1 19 18 11 11 24 1 44 32 40 47 1 18 17 37 47 1 45 14 15 23 1 1 1 2 2 1 26 1 1 2 14 26
17 26 28 1 23 33 16 49 30 29 17 17 18 20 50 17 23 49 15 30 24 17 12 8 25 17 1 25 38 31 1 21 33 34 1 11 29 14 30 9 22 17 1 1 18 10 1 34 36 48 4 6 28 49 25 3 34 32 49 20 1 17 33 39 7 14 34 47 1 49 21 32 20 10 23 1 26 39 32 1 37 16 43 9 39 12 1
12 23 7 1 43 1 19 38 17 15 15 42 12 41 16 1 39 6 1 27 37 8 21 47 14 48 16 38 50 42 11 27 50 24 34 1 10 20 28 32 33 8 3 1 1 13 35 1 17 37 40 1 50 7 1 47 39 34 46 1 45 7 35 16 34 9 26 27 16 27 1 1 50 5 28 29 41 43 36 6 14 1 1 1 8 17 44
39 33 30 13 1 46 20 4 34 6 3 29 1 14 28 27 3 25 1 2 1 25 1 1 1 1 12 49 8 17 1 1 26 40 5 11 21 36 34 50 1 41 1 7 7 27 34 27 49 1 8 6 49 47 24 30 1 47 13 39 23 49 10 25 27 16 14 10 33 1 39 1 1 1 1 18 1 38 36 33 49 1 1 49 12 23 9
25 4 35 27 28 1 17 1 14 1 44 1 27 41 43 50 8 22 25 48 45 43 36 7 1 47 1 1 1 15 6 26 1 1 43 1 33 28 42 40 12 5 19 29 44 48 21 32 1 47 2 33 10 3 1 20 1 1 20 49 14 7 28 1 1 35 25 6 20 31 1 20 1 1 1 7 40 32 1 1 16 41 18 1 49 17 43
5 25 34 17 4 36 20 13 35 1 45 20 21 38 1 20 1 14 1 27 1 35 35 6 9 42 5 5 1 24 35 8 1 49 1 11 29 26 27 7 1 14 15 23 23 38 39 1 49 1 46 34 32 21 13 1 39 49 33 28 18 23 1 25 1 6 20 27 2 28 41 50 1 24 10 31 1 1 50 16 44 8 1 1 1 6 1
27 30 1 45 47 14 1 1 14 32 33 8 36 8 5 2 33 35 1 12 50 8 2 5 18 3 20 7 1 33 12 19 22 18 12 48 1 50 20 46 49 5 47 13 3 9 46 26 1 11 1 1 1 9 49 7 48 31 5 5 46 1 19 36 7 26 47 6 46 13 2 1 17 17 1 1 1 28 36 44 12 19 36 14 1 33 43
14 36 40 44 45 36 29 43 31 14 1 23 20 28 20 48 37 38 20 47 12 47 19 4 43 1 1 6 8 19 19 24 30 7 1 4 12 35 1 19 1 1 10 45 47 26 31 11 21 39 44 1 15 1 33 7 26 1 8 36 19 2 18 1 4 1 1 41 14 30 1 9 28 33 20 36 42 26 20 47 50 13 23 2 1 37 47
1 27 25 26 19 34 31 30 39 19 26 13 37 7 33 6 1 21 23 18 42 45 8 43 5 4 29 31 1 36 26 36 16 30 39 45 2 33 28 30 23 31 17 26 12 1 9 1 30 42 34 6 1 30 3 28 5 1 19 1 6 1 9 47 11 13 15 4 50 46 1 32 32 48 9 47 14 19 20 17 1 46 31 11 1 34 44
1 1 45 43 27 37 4 48 1 1 7 5 35 1 2 31 1 1 47 1 24 19 1 22 16 47 28 1 24 9 23 33 8 41 16 34 47 1 1 14 3 22 17 34 26 29 37 1 33 23 1 20 10 48 22 3 32 44 1 7 1 1 39 3 37 46 19 1 1 50 43 35 1 1 1 13 3 28 1 10 1 31 35 4 1 1 45
42 28 36 1 25 31 1 1 47 17 1 24 50 1 1 17 29 1 12 22 48 1 1 1 50 38 24 29 4 35 39 43 26 48 50 38 36 1 1 36 23 12 35 9 3 1 1 48 4 5 29 21 24 2 20 41 2 15 12 23 1 1 22 50 10 47 8 1 26 1 14 1 4 6 50 39 1 42 31 18 10 18 16 38 1 7 37
1 1 1 41 26 6 26 42 22 34 9 1 15 32 43 47 5 34 2 21 32 13 50 50 37 35 13 1 21 13 40 1 1 39 27 46 20 14 9 19 27 1 9 31 20 5 24 27 43 47 41 43 1 39 1 47 12 1 22 3 19 1 43 1 41 40 2 42 3 39 1 22 33 49 41 30 6 48 1 32 17 34 30 48 1 9 50
41 33 1 1 22 46 1 38 1 41 1 11 23 39 31 29 37 33 22 3 48 1 12 1 1 11 31 46 1 1 17 43 1 18 17 1 31 1 17 25 42 41 45 3 1 19 1 19 1 37 36 8 9 33 29 14 11 40 8 27 45 50 19 1 7 1 12 1 16 19 49 15 21 1 40 42 17 29 1 41 25 12 20 37 1 20 1
44 1 39 27 25 1 1 16 31 1 12 1 36 1 1 1 46 1 45 1 2 39 10 1 1 48 3 7 1 25 37 40 19 15 34 35 16 22 27 41 23 10 25 19 31 7 39 17 1 26 41 25 1 8 44 30 19 30 43 44 1 26 32 40 1 11 1 4 31 31 1 26 1 16 1 20 20 16 42 47 32 1 21 49 7 4 24
48 1 1 20 13 39 9 12 39 42 38 18 35 39 1 15 1 42 47 34 25 1 12 22 1 22 17 15 18 6 7 1 26 11 24 36 1 27 4 43 39 8 1 4 5 26 1 20 1 35 44 40 38 1 1 29 2 39 14 7 45 1 44 1 39 32 32 1 4 1 3 15 4 7 49 47 17 38 9 39 47 14 27 15 1 39 27
6 26 20 41 40 7 43 18 1 33 1 41 12 31 14 10 43 2 47 1 1 1 36 36 47 24 12 17 30 1 42 32 29 1 1 17 9 17 34 10 47 17 7 1 3 38 35 4 48 37 1 1 26 41 37 1 6 11 12 6 2 38 19 36 9 2 28 1 24 47 30 1 20 31 1 33 1 21 45 1 2 1 1 31 26 1 16
41 21 25 1 41 41 29 1 1 1 7 18 50 8 1 25 35 44 28 34 23 18 32 10 35 1 46 1 1 10 42 18 1 1 47 10 27 50 7 6 1 30 25 46 1 20 1 10 17 13 17 7 50 4 5 11 1 25 14 10 38 36 17 27 33 41 10 31 23 30 2 7 39 1 32 27 49 42 50 33 39 47 1 20 24 1 1
47 1 10 3 22 11 1 31 43 29 15 29 33 17 9 16 32 9 1 42 1 28 2 47 15 41 1 17 13 37 27 1 24 40 17 1 47 1 7 4 1 26 8 17 1 3 15 1 23 21 11 31 19 20 17 37 37 1 41 23 19 15 1 49 13 1 32 49 50 42 6 6 1 1 23 1 48 39 5 33 10 26 42 28 43 9 2
5 5 1 48 8 28 3 42 1 1 7 39 1 42 13 48 16 48 27 1 49 47 4 18 37 46 32 16 1 24 35 38 38 19 1 21 42 46 30 25 36 6 35 1 2 1 37 42 11 1 26 41 1 23 10 14 33 5 40 12 6 8 1 46 1 1 48 39 1 32 16 21 1 29 11 1 1 4 1 50 45 21 30 1 32 43 1
1 1 4 43 17 8 1 1 1 5 37 1 36 30 7 1 1 1 24 33 20 18 24 49 8 8 46 1 46 1 1 31 1 20 4 5 1 17 41 12 41 1 44 10 37 1 5 45 32 35 9 5 18 8 16 40 40 41 6 38 6 1 1 29 38 14 5 1 17 35 48 28 1 12 23 50 6 44 12 27 1 12 13 2 25 1 18
1 6 1 37 1 42 15 35 45 1 20 33 50 1 7 1 30 29 10 2 31 16 33 7 8 5 1 49 48 9 24 47 27 29 22 39 37 50 1 1 1 1 1 1 12 18 38 9 50 36 1 39 1 11 27 41 4 39 1 15 10 12 44 48 6 5 21 4 41 20 7 19 40 45 10 1 24 1 22 1 40 49 32 17 14 9 1
50 9 44 2 1 10 34 32 3 1 1 49 47 34 24 26 31 13 22 1 36 1 9 1 14 14 1 1 1 14 1 41 22 16 50 1 16 1 35 34 3 31 38 44 12 1 31 1 48 45 33 18 1 39 1 10 1 28 29 1 32 1 1 1 39 14 15 49 29 22 1 1 21 1 46 1 12 1 13 41 41 5 1 26 1 49 26
1 18 36 41 1 1 8 42 45 1 20 1 1 13 12 37 46 1 31 28 29 46 28 5 50 36 50 48 4 31 6 5 1 23 1 14 1 1 30 16 18 12 15 29 34 24 47 30 31 1 1 5 9 12 29 38 9 3 45 22 18 29 14 1 19 25 24 14 50 36 1 44 3 17 46 1 43 1 1 1 1 1 31 11 22 24 16
48 48 39 38 28 34 46 14 48 26 5 18 12 16 37 39 1 45 1 8 20 29 27 49 23 31 6 1 22 11 38 25 15 38 23 36 38 1 9 40 31 7 46 45 1 48 46 31 23 48 34 6 7 41 4 15 19 1 20 27 29 1 1 7 36 1 3 1 1 11 33 43 22 18 43 7 1 12 32 26 40 8 21 18 1 13 1
1 20 25 48 32 25 4 42 1 1 35 40 1 48 3 48 19 41 23 42 9 31 13 42 13 16 27 1 1 1 1 31 1 40 1 1 8 7 1 1 1 42 39 20 47 33 3 42 47 4 14 24 18 29 1 9 1 38 37 24 45 44 1 9 24 1 1 10 32 30 30 1 11 18 31 14 15 42 47 16 43 14 1 22 31 8 32
1 9 40 50 26 9 23 8 1 1 3 1 5 36 6 1 1 41 17 13 1 22 1 1 1 24 19 43 7 40 22 41 30 10 1 1 23 6 5 36 45 12 12 11 16 1 1 37 7 29 19 48 1 1 47 1 48 15 15 9 3 1 23 1 1 28 1 23 40 47 21 26 11 44 28 1 18 35 13 50 35 7 5 29 26 35 1
28 27 40 37 22 7 5 5 37 46 5 1 46 40 4 9 35 21 42 32 27 47 20 3 1 24 34 25 1 24 1 39 1 1 40 26 27 43 1 49 1 27 1 6 1 1 13 1 27 20 17 5 48 15 7 1 50 27 46 46 19 1 23 26 13 1 30 11 26 3 5 26 16 12 13 39 1 8 20 40 7 1 44 43 37 1 4
10 30 19 29 38 34 47 2 35 1 25 18 43 7 11 12 1 35 1 1 24 43 44 21 31 1 1 48 24 8 1 32 1 1 41 1 46 42 36 34 1 1 4 10 6 4 11 3 40 46 8 1 8 1 17 10 1 1 4 42 1 26 38 24 1 1 29 1 37 39 44 9 4 1 4 1 20 11 11 10 29 1 3 49 46 45 18
35 43 1 1 7 20 4 34 5 40 22 8 11 16 50 1 29 43 20 1 15 24 37 40 24 36 44 40 11 34 1 38 40 12 37 1 2 29 29 1 43 1 1 27 32 9 27 1 1 44 37 35 23 44 48 1 8 9 47 50 12 1 1 4 23 1 1 11 22 20 34 15 23 39 10 7 9 6 6 3 21 10 19 1 10 1 46
27 7 1 41 1 20 8 39 44 27 19 33 38 33 29 41 11 31 31 4 38 4 50 36 46 1 19 22 15 22 7 7 24 39 15 49 12 1 36 26 46 42 1 28 25 17 10 12 48 1 37 1 29 13 37 1 2 31 31 1 39 48 8 1 30 15 36 36 23 1 4 14 1 15 1 24 1 44 12 28 9 1 10 21 25 30 15
30 1 1 14 43 37 26 26 7 1 41 12 37 1 20 27 19 1 23 27 1 46 1 10 49 1 45 1 12 1 26 1 46 14 12 1 16 40 42 10 40 1 20 1 41 1 1 46 1 19 43 48 1 3 3 13 1 12 23 1 33 44 1 30 7 19 39 7 16 23 18 29 29 4 1 1 20 49 12 1 1 19 10 27 19 27 1
25 4 27 17 49 1 1 35 46 10 3 6 3 43 1 33 34 1 43 7 27 40 3 41 35 16 50 1 31 25 20 34 8 9 46 4 44 30 1 1 12 1 1 49 1 10 49 1 24 37 30 2 7 35 37 49 38 42 13 1 1 44 10 41 19 46 1 1 1 35 33 9 4 11 10 1 18 35 14 1 1 1 1 41 37 33 29
50 18 35 1 49 39 1 38 1 28 40 42 2 35 1 34 50 10 1 28 25 48 33 23 35 21 22 46 47 46 1 31 1 1 49 1 2 41 38 44 16 3 34 35 34 1 47 35 1 50 24 50 47 25 2 41 1 4 18 36 1 1 35 30 1 1 1 1 41 40 10 1 5 42 26 47 34 3 1 1 15 20 13 19 10 38 43
38 48 4 31 16 37 50 1 30 39 27 1 41 31 9 21 31 10 18 31 1 11 27 43 4 1 45 9 1 15 48 35 1 32 8 1 48 3 24 44 13 10 20 19 3 5 35 48 20 1 34 33 1 30 1 2 50 31 1 27 1 4 1 21 45 35 1 3 1 31 41 49 43 5 25 11 39 35 38 31 1 25 44 1 8 2 10
1 1 3 32 1 7 50 45 46 6 1 29 6 1 3 32 38 29 7 10 1 16 43 1 18 1 1 35 7 1 32 1 5 14 21 41 1 46 6 28 35 47 6 49 36 1 2 2 28 1 24 31 6 33 3 1 48 1 43 43 17 32 41 48 1 1 1 37 13 6 20 27 38 4 24 9 23 44 23 43 23 1 27 32 1 10 1
42 13 1 5 2 1 1 48 1 1 13 7 1 15 40 1 12 27 32 12 1 13 25 46 21 48 21 19 2 14 1 11 44 1 43 16 40 42 43 1 43 36 43 14 10 1 1 1 31 32 1 39 35 50 5 8 15 14 19 48 1 1 39 32 32 30 2 47 1 12 1 14 40 1 6 1 9 38 33 40 15 25 18 4 1 37 25
35 4 1 23 3 32 16 15 12 19 21 33 24 37 34 15 5 28 33 1 1 1 39 18 2 45 1 1 17 8 1 1 35 8 39 32 15 19 12 15 11 1 4 36 37 8 28 4 30 24 47 48 38 49 29 11 1 1 33 1 7 17 47 1 48 26 17 50 4 16 7 1 26 11 29 22 27 1 24 1 33 4 44 3 43 24 40
1 1 46 42 13 7 1 46 20 20 1 3 1 1 17 29 11 30 49 1 50 7 6 1 48 14 9 1 24 23 1 33 1 45 1 34 41 23 19 1 22 28 17 18 6 13 1 1 1 17 41 34 36 31 1 1 37 47 49 1 45 2 24 45 48 37 1 14 42 32 47 36 1 1 1 41 1 17 34 1 26 29 47 1 1 40 26
1 1 1 14 1 12 27 1 15 13 1 35 41 44 22 15 3 50 33 48 1 17 11 41 39 2 4 14 2 26 1 30 7 1 35 31 17 39 1 44 1 19 1 49 15 5 46 31 1 34 45 27 1 14 19 49 42 14 28 1 21 1 7 36 29 43 36 1 42 8 5 50 1 34 1 39 30 31 1 12 15 18 25 11 7 10 49
43 1 12 1 20 1 30 22 29 1 1 16 1 24 33 23 45 49 1 13 13 1 42 49 1 9 44 38 1 37 41 6 1 31 46 16 25 34 20 1 6 11 48 13 24 20 1 45 1 16 33 27 21 23 1 25 19 29 36 42 44 1 20 16 35 34 39 40 43 24 50 35 5 27 45 26 43 44 22 25 1 43 23 1 4 6 1
1 5 25 42 2 28 8 11 39 23 23 19 1 2 12 1 17 3 23 1 41 15 1 18 45 1 1 19 1 11 26 41 42 42 37 48 1 1 27 50 42 12 1 31 34 32 1 1 44 1 48 1 45 1 30 43 26 27 46 50 26 1 1 1 10 2 16 37 20 1 50 39 21 33 23 1 18 19 2 47 1 1 16 44 31 3 30
23 28 38 1 8 1 44 9 1 39 31 18 31 22 49 26 1 10 34 22 1 46 1 39 35 30 16 45 45 39 37 6 26 15 1 46 42 44 27 46 30 48 1 8 44 44 1 1 39 9 18 4 5 49 45 20 9 36 49 50 9 46 31 1 10 13 12 1 10 11 28 16 28 11 36 21 9 20 24 47 1 28 34 1 8 22 38
42 1 48 1 27 2 4 45 1 15 48 22 1 13 7 1 42 16 1 1 17 16 22 22 1 1 29 34 16 49 36 37 39 19 14 49 1 45 36 19 41 22 21 17 27 5 25 41 45 7 34 6 25 1 30 40 1 1 1 1 5 37 6 8 1 29 16 47 7 1 1 22 27 45 11 45 14 33 1 2 19 24 7 5 20 36 41
7 12 11 27 45 1 28 25 6 6 45 16 1 46 24 31 40 47 1 25 48 1 33 33 37 1 19 31 9 35 1 47 39 5 41 21 46 1 1 1 21 5 25 23 7 1 24 6 21 49 27 36 1 25 44 1 1 36 44 7 1 21 46 21 27 25 18 43 1 20 49 1 15 23 1 5 4 4 1 31 15 46 28 43 7 5 1
5 25 1 8 37 40 6 16 22 1 1 3 50 8 1 29 48 1 1 1 14 33 16 1 31 14 21 13 12 49 45 31 11 14 10 14 1 42 47 47 1 49 1 23 1 36 1 1 12 1 28 32 9 50 3 28 26 33 32 43 1 39 31 1 31 26 47 1 9 32 1 24 11 21 19 44 23 5 7 49 29 19 33 34 1 1 7
36 24 1 1 9 10 32 10 15 45 38 13 1 32 14 41 37 25 1 1 45 30 31 10 46 13 27 16 20 1 1 19 19 38 1 1 49 36 48 5 37 1 32 26 49 3 1 34 10 43 15 48 1 1 1 19 20 43 15 11 46 1 2 20 14 12 3 18 32 1 41 36 27 42 1 34 20 35 1 14 18 20 3 49 20 2 22
39 42 19 8 1 7 1 37 5 9 1 14 1 7 46 33 35 16 46 50 12 1 27 1 1 10 47 1 1 49 14 27 20 44 2 27 19 17 1 1 1 7 29 42 45 46 41 37 42 1 1 1 6 14 35 3 15 28 1 44 13 21 18 47 9 29 44 7 48 8 15 23 50 44 1 26 20 35 1 22 1 33 1 31 19 12 16
44 1 1 8 45 10 25 31 44 1 1 1 49 11 11 1 1 9 7 25 36 29 44 1 1 10 48 40 2 28 33 1 42 30 8 17 17 1 26 7 39 32 1 33 1 35 3 27 3 19 39 39 23 12 1 11 23 11 6 46 39 19 40 1 47 48 1 49 41 36 12 24 30 46 41 1 36 13 2 25 34 17 45 1 25 26 1
34 21 30 23 13 3 1 22 1 1 26 10 16 36 40 1 18 15 21 9 39 1 13 1 9 1 35 26 38 1 8 45 18 1 5 36 1 14 1 37 45 36 4 46 2 2 1 1 27 24 43 1 1 11 35 28 35 1 1 1 48 1 12 1 48 17 50 35 42 1 32 10 26 31 27 28 37 1 37 29 12 26 42 11 21 28 42
19 35 1 24 50 1 8 12 35 1 12 41 19 1 30 11 1 27 21 9 50 25 12 40 11 33 29 20 11 7 47 6 1 19 1 17 1 1 1 1 38 1 44 1 15 50 1 46 6 1 34 36 44 13 9 29 43 31 18 27 1 18 28 38 4 14 1 25 9 47 23 26 33 6 37 10 25 1 31 28 33 21 1 44 25 39 36
41 37 31 27 15 12 6 9 10 45 25 20 1 6 40 41 23 11 1 19 2 35 1 1 40 14 17 1 1 29 37 25 44 1 41 1 1 1 13 1 37 1 4 25 1 18 14 1 14 49 21 15 23 34 20 34 6 23 36 50 24 28 27 5 8 2 17 43 11 12 1 1 26 1 10 1 1 1 3 5 18 5 26 50 1 29 16
1 20 1 1 44 1 1 50 21 50 20 1 47 1 32 26 22 32 45 12 22 22 39 14 24 30 42 1 11 20 13 31 12 25 1 1 24 6 2 1 32 1 1 1 48 17 46 1 1 49 22 36 7 1 12 47 16 40 1 8 2 49 50 12 5 1 43 1 39 25 16 20 1 46 1 30 36 14 1 18 45 39 9 33 21 1 38
43 37 1 13 35 22 18 1 30 21 6 44 34 41 35 2 42 13 1 23 40 1 32 9 28 47 9 25 5 41 26 42 1 31 1 47 1 7 29 3 36 38 48 33 1 16 30 4 9 1 24 32 35 11 36 28 12 38 1 1 42 43 10 17 1 44 21 28 25 40 2 45 39 2 21 34 1 15 38 23 2 30 1 29 1 1 27
8 48 46 50 7 1 20 47 3 1 1 30 20 18 1 50 5 1 10 1 44 45 24 11 40 36 37 24 42 36 2 1 32 28 33 17 22 7 17 40 1 14 30 11 44 3 19 34 1 1 1 1 42 40 7 13 7 1 50 16 26 21 13 1 45 21 20 29 12 7 23 20 9 37 6 2 44 1 10 47 36 12 26 5 8 33 4
49 1 37 1 33 16 26 1 12 30 31 36 1 12 1 4 42 47 16 6 44 3 43 17 19 32 1 25 29 36 24 36 47 3 1 6 50 38 1 49 11 48 1 29 1 26 17 6 30 42 1 44 7 48 25 8 40 44 14 1 1 1 17 29 1 1 45 16 41 1 41 14 1 49 32 37 37 15 14 19 32 7 21 1 16 47 1
17 19 15 3 46 21 41 10 17 11 10 11 1 34 18 22 1 20 1 48 37 1 34 44 1 1 44 13 39 11 43 44 1 32 45 21 1 2 1 25 45 12 2 35 1 1 11 5 11 1 49 36 49 17 1 43 31 1 1 31 34 17 10 17 33 15 49 22 43 1 29 30 1 14 43 18 14 16 41 17 30 38 17 5 20 8 31
6 1 1 7 24 49 15 14 23 9 49 41 44 38 1 1 1 25 45 1 17 47 50 24 50 33 42 38 1 42 1 1 1 1 17 40 1 39 1 31 10 37 24 8 24 9 48 4 27 1 8 25 5 48 1 1 40 1 7 41 34 9 36 39 27 15 25 9 26 7 50 38 1 35 1 8 38 4 8 21 7 3 16 30 1 26 10
32 3 1 1 1 1 27 29 29 45 33 37 31 41 38 42 46 21 1 38 22 5 5 11 25 28 30 1 1 1 16 1 40 16 29 31 16 1 35 5 25 49 43 46 44 32 35 1 48 14 36 49 11 37 1 1 18 21 1 41 31 1 1 39 1 1 30 49 14 35 5 22 18 1 33 24 41 9 11 19 41 26 1 8 1 28 13
33 7 31 26 26 33 37 24 1 10 25 42 26 1 27 24 36 12 15 37 2 28 31 41 1 1 1 1 31 42 44 28 30 19 1 31 1 7 27 49 50 21 45 18 17 3 27 8 3 15 13 48 44 1 43 10 46 29 7 1 33 4 1 40 20 1 1 5 1 18 42 1 1 12 45 1 49 32 24 50 49 15 17 6 9 1 1
1 40 40 1 46 1 8 1 25 1 3 14 50 18 2 36 30 28 1 49 30 11 8 1 32 1 1 8 41 14 1 26 9 15 3 6 14 49 48 41 1 1 14 1 1 1 1 28 43 38 2 26 13 23 49 35 4 21 1 43 4 27 18 42 31 1 7 1 38 1 1 3 1 12 23 36 41 1 40 5 8 32 38 23 36 8 8
26 34 1 33 6 16 30 46 32 30 3 30 44 1 33 29 31 1 42 7 39 38 1 26 24 1 1 37 33 9 16 1 41 47 47 22 4 1 35 12 1 15 42 24 1 31 23 13 4 40 2 1 20 1 26 18 9 5 8 41 46 35 9 20 35 26 34 1 45 45 39 14 31 7 5 43 15 1 19 10 11 21 1 37 1 31 43
41 26 1 1 20 27 14 14 45 38 1 10 16 17 38 8 1 39 1 6 5 32 1 1 12 29 4 17 1 44 1 43 39 10 31 1 47 40 45 32 1 13 1 1 17 30 28 19 16 10 25 2 6 40 48 36 30 1 36 1 48 8 35 42 4 1 4 38 1 1 1 39 35 33 29 1 36 12 21 20 29 1 11 19 34 1 38
35 5 49 24 23 28 5 42 9 37 13 1 26 1 5 23 21 3 1 43 45 1 1 23 47 37 18 17 2 2 1 1 1 37 46 1 1 1 42 1 36 40 31 34 4 26 26 1 7 43 1 47 1 46 21 1 18 1 41 50 25 1 33 3 40 39 46 1 1 49 38 21 19 17 18 12 27 1 41 33 33 4 17 24 6 34 21
20 43 49 4 9 43 33 1 1 1 4 16 19 30 6 25 37 35 24 32 16 26 48 19 9 19 48 1 29 4 23 36 25 1 21 28 45 39 45 38 18 25 45 48 19 26 24 45 2 1 22 48 49 1 22 4 42 2 8 1 1 8 16 40 9 32 32 13 3 32 17 44 6 1 19 40 1 37 1 21 14 1 1 13 3 3 25
47 1 40 1 5 29 7 22 39 27 23 12 15 1 1 16 42 44 4 24 1 40 47 4 2 26 39 17 35 6 6 1 11 5 37 13 23 49 8 49 10 45 10 18 18 1 11 20 48 2 23 2 1 22 6 1 8 35 1 29 39 21 2 34 26 11 37 6 50 7 46 41 46 8 15 2 8 1 4 13 30 21 43 1 41 27 15
40 5 30 19 18 12 31 1 5 10 30 9 1 9 8 1 5 13 1 50 32 8 20 7 1 23 20 21 39 42 44 20 25 1 1 27 23 1 1 24 23 1 30 13 42 1 48 3 16 12 11 14 27 20 43 11 16 26 33 27 30 4 1 41 19 14 22 46 18 1 6 49 13 7 26 48 11 45 3 1 1 18 32 1 49 1 30
34 1 48 35 11 29 10 29 1 15 16 22 24 24 37 46 19 49 30 27 26 27 1 1 15 21 1 17 24 1 47 1 49 35 1 12 50 13 13 2 1 1 23 18 38 9 48 47 42 1 1 6 12 44 1 1 20 35 12 1 1 46 1 12 1 43 16 1 19 1 5 10 7 48 18 25 13 15 1 34 27 29 27 1 39 16 17
37 27 41 50 1 24 7 2 12 22 6 1 12 26 28 1 8 29 12 39 44 45 31 6 1 16 40 21 40 3 3 49 3 46 1 38 1 18 31 16 28 47 45 4 26 36 31 20 47 47 12 26 19 26 2 1 1 9 17 40 45 30 9 36 12 21 11 21 50 38 4 2 1 10 25 1 50 21 37 1 29 28 8 25 1 7 42
45 1 42 25 1 4 31 1 45 50 15 46 16 37 6 47 15 32 1 31 18 1 1 29 1 4 6 48 1 7 49 1 4 1 38 2 18 50 11 8 12 48 39 1 24 49 11 49 1 1 1 32 6 6 39 7 42 5 1 48 49 1 1 1 40 9 1 24 1 9 1 34 46 42 44 26 23 7 27 1 42 34 21 37 32 6 16
20 49 44 4 23 33 3 41 1 27 33 38 45 42 11 25 47 33 40 7 1 36 8 42 1 30 9 5 31 26 12 14 6 4 41 2 42 35 12 24 1 3 20 41 1 5 12 25 1 1 28 22 24 22 22 44 3 9 17 20 8 38 24 7 1 43 15 24 33 32 1 29 1 32 40 32 27 1 1 1 10 44 1 46 7 14 9
47 26 12 20 1 35 1 6 11 6 49 18 6 50 18 35 19 23 3 14 11 12 8 1 43 24 11 23 34 1 22 3 1 1 21 21 31 50 17 33 4 36 1 16 1 14 7 23 36 1 48 1 10 6 35 44 1 7 31 17 1 6 1 1 34 14 1 32 19 49 47 1 34 1 19 21 16 47 18 27 1 1 37 1 19 23 41
1 41 46 48 42 37 1 1 43 39 18 31 14 24 30 4 44 17 1 13 3 7 27 6 27 17 31 22 38 36 1 1 31 29 1 47 1 1 32 14 17 32 36 21 41 39 7 10 46 1 15 39 50 17 50 1 1 1 18 14 1 1 33 1 41 1 24 10 34 48 1 47 11 1 1 1 49 13 37 39 1 40 50 1 8 31 13
47 43 24 38 28 23 49 1 18 1 44 40 27 38 28 50 14 1 23 2 5 32 33 20 3 17 1 10 42 1 34 1 35 7 24 31 17 50 5 1 26 3 42 19 28 26 29 20 26 43 24 1 18 18 48 1 1 48 1 42 1 21 1 1 46 29 24 36 26 35 26 26 16 22 28 43 30 20 15 50 1 1 29 11 20 16 42
36 4 22 1 1 39 36 8 38 1 25 48 43 5 22 27 45 5 20 30 7 1 1 1 1 1 31 32 2 3 32 30 48 1 32 12 20 12 45 24 49 6 7 6 49 22 23 50 42 1 15 23 10 1 1 12 18 5 1 3 1 1 15 33 32 10 41 1 40 5 44 32 21 1 47 48 2 10 23 1 48 23 45 28 43 43 36
2 41 25 20 6 50 1 40 13 35 12 3 23 27 15 1 27 1 18 38 35 28 32 1 42 7 25 41 50 28 1 32 1 50 32 6 30 3 41 16 21 1 28 47 1 1 12 44 1 1 1 17 16 7 6 50 46 1 19 29 45 1 28 12 38 35 16 6 22 4 39 15 48 48 25 18 11 1 28 41 49 47 19 14 38 1 36
18 42 37 25 1 48 36 14 24 1 31 46 49 12 19 28 5 43 1 27 1 25 9 23 11 24 8 43 43 1 1 37 10 1 16 36 32 33 1 3 21 13 46 1 37 49 23 1 40 2 1 3 37 9 1 1 8 26 1 30 27 14 1 3 41 13 21 24 49 1 49 44 25 45 31 35 1 45 3 1 13 9 41 1 1 42 48
31 23 46 17 1 43 46 36 38 50 27 38 18 3 44 33 49 6 24 8 5 6 1 2 44 41 1 37 25 45 30 20 24 27 8 27 1 10 1 28 1 38 46 1 26 5 29 1 34 44 9 1 29 1 1 22 1 14 49 19 33 1 1 1 24 1 6 35 1 1 9 30 48 25 1 1 4 1 27 40 11 35 25 1 47 45 13
