86
5 7 14 67
1 29 33 1 12 10 27 13 1 1 24 26 1 1 7 18 1 30 1 5 5 18 14 29 17 1 1 1 18 16 27 22 20 1 1 1 23 8 36 23 7 48 13 37 23 13 39 26 49 1 9 15 18 1 1 1 1 32 14 1 1 5 2 15 19 47 33 13 16 9 1 44 1 38 45 20 1 11 41 18 30 1 18 42 35 37
1 17 49 45 32 49 4 43 2 1 1 41 2 41 10 50 7 20 35 21 45 12 1 38 34 12 19 17 17 1 38 38 21 50 21 20 42 32 17 21 1 1 1 31 21 40 35 15 1 38 1 11 19 1 2 27 1 8 50 41 1 1 5 7 38 43 19 15 23 17 39 4 8 5 21 33 34 5 34 20 2 7 1 30 17 19
33 33 18 44 2 50 20 30 23 1 10 3 18 4 1 22 13 33 27 1 25 1 30 17 35 36 5 22 50 42 26 33 9 1 9 30 30 18 23 21 5 1 23 42 10 32 38 24 7 1 23 33 38 1 31 1 23 43 15 50 1 27 29 18 1 1 31 35 1 44 27 30 6 9 1 27 1 7 35 28 1 43 7 13 25 1
13 5 1 34 44 1 2 19 1 1 31 12 21 10 47 26 42 1 8 29 1 45 28 4 15 12 13 14 35 17 1 33 1 35 2 40 1 1 1 1 43 10 1 31 1 46 43 1 50 21 50 46 36 7 48 2 34 43 5 49 8 9 30 26 10 1 48 38 1 41 47 19 46 32 5 39 31 31 3 19 8 14 42 39 44 42
11 45 11 48 22 17 11 36 1 1 1 29 23 16 35 50 22 2 1 31 36 24 1 49 16 1 13 22 1 1 12 1 42 40 8 1 1 18 50 47 18 12 35 11 1 3 21 1 7 47 28 36 17 36 25 35 1 1 34 26 40 32 9 2 38 34 8 47 12 24 48 6 22 34 22 45 1 47 22 6 33 44 35 25 1 11
21 47 36 25 32 44 39 31 27 47 25 38 34 17 10 1 30 8 1 1 44 1 28 1 24 36 44 21 10 1 1 20 9 35 31 31 30 42 31 19 1 23 21 2 1 27 22 16 46 5 49 1 1 4 36 20 23 15 38 24 36 1 1 40 39 13 1 49 29 12 47 44 1 23 45 1 4 1 26 2 15 43 25 1 38 1
47 27 41 36 1 34 36 13 1 1 49 47 1 37 23 23 27 40 33 16 7 36 1 33 34 41 1 18 23 24 25 43 1 37 23 5 20 31 2 1 43 1 1 16 36 1 46 6 50 1 10 45 3 12 1 20 13 31 4 1 18 1 10 3 23 1 47 1 42 1 1 1 1 16 1 12 15 49 17 37 1 2 1 1 48 46
42 1 21 20 29 23 16 5 16 10 41 29 43 48 43 15 28 22 5 12 1 1 31 30 34 26 31 1 3 1 45 26 20 24 16 48 5 14 39 12 41 11 1 47 1 45 31 48 44 19 7 38 42 11 1 15 4 39 21 27 14 13 1 35 2 43 35 10 1 47 1 1 39 24 1 41 38 29 38 47 1 42 21 8 6 21
22 7 42 25 3 42 4 27 36 9 4 8 21 39 2 36 9 30 28 27 26 11 6 1 21 12 41 1 2 35 32 3 21 1 23 41 44 16 33 24 23 32 43 44 50 38 35 24 18 23 1 1 27 34 18 33 1 14 5 33 38 1 12 43 42 5 1 26 14 18 23 42 1 35 18 1 17 1 48 10 30 35 48 33 1 42
11 39 1 2 1 25 15 37 36 39 1 22 50 45 1 30 2 36 16 28 9 12 18 11 1 1 21 30 43 45 18 22 40 25 41 46 45 11 13 10 21 11 45 45 23 5 8 28 42 1 48 10 26 1 46 1 1 24 35 40 12 26 1 31 1 15 7 50 1 4 14 41 32 16 41 13 50 36 3 20 29 29 41 21 31 1
11 1 16 1 16 31 41 1 1 16 1 1 1 1 45 16 46 1 45 18 1 4 1 15 31 47 50 38 26 1 25 29 22 1 47 1 1 1 8 6 25 1 44 1 1 1 1 38 49 50 38 34 13 23 36 18 49 1 4 24 1 8 26 34 1 21 35 25 34 47 1 1 2 26 10 13 28 14 4 30 36 50 39 1 31 33
42 30 43 6 30 7 5 25 17 1 1 49 1 22 1 10 44 49 1 1 32 16 12 39 2 1 7 1 8 44 1 46 28 44 38 15 9 40 3 21 49 45 1 10 27 26 23 24 34 41 10 7 13 25 1 24 29 24 34 1 17 31 3 12 19 13 34 50 42 31 39 27 25 34 2 9 40 16 26 31 41 38 20 6 1 23
31 1 45 26 22 34 41 39 25 1 1 36 4 29 45 34 1 1 19 17 44 15 1 2 29 38 11 17 1 1 1 38 5 1 48 30 15 22 4 37 40 33 36 46 44 47 4 42 3 26 1 1 1 46 35 11 1 17 24 45 39 45 50 1 50 1 1 47 31 45 7 22 35 1 47 1 43 1 29 39 4 26 11 1 19 30
1 40 1 36 28 43 1 31 1 24 29 2 1 1 1 1 1 31 39 1 28 1 20 12 20 1 1 1 1 5 20 24 1 31 4 47 24 20 11 6 1 1 1 14 36 2 5 4 18 24 1 45 5 41 42 8 1 31 29 16 1 38 46 43 22 32 29 6 1 36 6 25 9 5 1 1 1 1 21 1 16 43 4 42 24 8
38 34 20 3 16 1 43 13 39 1 1 20 1 41 31 35 1 20 32 1 1 11 31 1 37 1 8 19 26 1 1 7 30 48 37 13 5 22 24 25 1 12 1 50 30 42 37 1 17 16 1 35 19 6 46 21 20 39 40 37 1 9 40 16 49 34 3 23 18 22 45 36 23 1 22 47 2 41 31 1 38 38 1 1 46 18
20 2 7 5 46 33 18 8 35 21 15 45 27 18 34 1 9 25 10 16 7 2 2 5 48 1 1 44 1 38 23 15 41 24 12 46 15 42 40 1 22 6 1 47 22 1 14 27 43 27 14 49 24 35 24 4 33 31 4 1 1 26 15 47 1 13 47 46 1 26 48 1 41 27 6 45 43 1 37 7 50 36 29 36 25 8
50 26 37 19 50 19 1 1 39 25 20 1 44 1 1 49 1 1 2 1 15 18 25 4 34 41 30 12 28 35 44 17 1 5 1 27 9 49 14 31 19 3 47 45 14 45 1 8 11 1 1 3 41 22 9 1 33 13 49 14 16 9 1 1 35 47 40 29 1 6 1 23 26 10 2 41 45 47 1 12 1 26 47 1 40 15
18 28 28 1 37 44 9 1 43 1 7 12 31 26 40 39 1 22 7 20 9 15 13 25 1 46 7 6 17 28 1 1 21 9 1 38 31 1 1 41 33 4 1 48 3 19 24 18 1 1 18 15 12 19 21 1 10 50 14 14 11 7 33 1 1 35 42 36 1 40 21 44 37 19 14 38 42 16 2 25 2 30 10 17 32 50
43 30 29 4 43 6 19 1 44 15 21 22 3 3 30 48 10 1 11 1 12 1 1 32 1 1 13 14 2 28 23 19 34 41 50 50 1 31 1 40 1 1 35 36 12 16 49 22 46 34 1 11 49 28 30 24 24 1 1 47 37 5 13 12 1 1 31 38 9 32 28 1 24 1 46 6 22 40 45 1 18 10 1 38 1 1
11 1 33 1 3 9 13 25 1 48 34 49 22 6 40 26 13 49 44 1 46 20 33 1 1 35 43 6 43 16 47 47 49 41 4 8 1 33 34 12 3 42 2 18 21 34 1 1 46 3 16 50 1 22 37 38 29 1 1 32 1 26 20 1 28 1 13 5 1 1 1 24 1 45 25 18 16 9 30 49 20 1 20 35 1 43
1 16 9 10 26 46 32 30 46 26 33 1 38 1 44 37 38 1 1 3 1 21 12 45 4 22 43 7 42 9 1 23 10 45 15 21 13 27 49 18 38 1 2 1 16 44 16 26 28 28 1 21 1 1 23 21 24 1 37 1 7 21 43 12 27 7 7 33 48 6 19 42 1 1 38 49 8 39 1 24 1 40 1 34 17 34
30 27 1 37 41 19 19 1 1 1 39 38 1 10 5 22 6 14 45 38 45 28 17 11 14 45 8 1 6 1 28 1 36 19 33 48 1 13 1 37 3 41 40 8 1 34 39 50 37 40 21 9 10 1 6 1 49 1 35 41 35 44 48 10 24 45 36 1 39 10 16 31 35 3 36 16 40 1 1 7 11 12 1 15 3 32
26 5 1 22 34 37 9 8 21 14 29 24 50 21 24 1 41 1 31 13 33 1 5 3 2 37 30 8 1 1 1 33 23 23 35 16 18 34 39 4 40 12 10 4 18 42 1 4 1 8 43 1 43 22 6 20 43 1 2 1 23 1 22 1 6 1 1 1 1 32 29 11 1 1 10 1 18 1 34 10 1 47 16 1 21 1
9 1 42 1 4 17 9 1 49 4 29 1 41 8 28 39 26 18 13 22 50 1 13 9 31 19 47 8 9 45 20 46 39 50 1 48 8 37 24 6 44 49 46 33 23 3 1 33 30 49 9 40 17 48 17 32 14 50 3 31 1 28 1 48 23 1 1 6 9 10 27 46 4 31 28 43 4 38 1 40 50 38 1 30 6 1
35 15 1 9 5 33 16 19 1 14 2 17 1 20 17 49 23 1 13 35 28 25 36 25 46 1 14 4 6 40 9 1 4 1 5 1 1 2 28 38 1 1 1 44 28 30 1 1 1 21 21 38 1 45 12 10 28 27 22 13 43 36 14 4 22 39 1 8 45 6 36 30 31 28 1 37 35 28 20 5 5 1 4 1 49 27
14 49 1 41 3 1 26 26 1 41 36 41 1 1 8 8 27 15 34 36 31 1 2 41 38 9 26 1 1 1 1 5 26 10 26 11 33 33 26 22 30 1 13 11 26 41 20 26 1 3 10 20 1 46 19 5 1 29 47 10 29 9 36 18 41 49 1 23 1 14 31 1 7 45 1 3 12 3 47 1 19 3 29 15 21 1
15 4 5 18 15 1 19 32 20 1 10 41 35 19 1 40 1 1 1 1 18 38 23 1 1 50 9 28 2 4 1 19 36 1 32 1 1 1 1 6 24 13 30 1 11 1 30 39 11 1 20 1 15 13 1 1 8 10 49 48 1 1 18 29 18 1 37 14 2 24 50 43 4 28 1 18 41 1 50 1 25 1 3 39 1 48
25 23 18 26 23 13 12 21 34 35 1 41 48 30 1 47 2 38 2 49 1 1 21 4 32 1 37 21 16 25 21 1 1 24 50 21 30 29 8 3 1 30 50 19 45 1 17 10 5 9 42 41 1 1 1 43 24 7 19 14 25 47 7 29 3 1 28 40 45 1 1 44 1 28 31 1 18 37 32 3 7 46 41 37 25 1
4 31 5 18 7 18 23 1 39 48 50 19 13 1 8 1 19 1 25 50 1 23 16 6 29 22 2 28 36 47 43 41 41 1 14 1 32 34 11 25 1 1 36 18 7 1 24 41 19 2 9 32 1 1 14 50 25 49 28 39 23 26 43 1 1 22 7 1 13 25 20 22 36 1 31 48 21 45 1 1 1 9 34 39 23 25
6 43 4 2 44 1 16 9 48 39 3 24 40 11 1 1 13 32 46 31 21 35 1 22 15 1 38 48 39 17 2 14 41 4 13 45 44 28 1 10 1 23 1 49 27 33 7 29 48 11 27 9 38 1 17 1 13 1 1 36 32 1 47 9 48 21 50 41 6 30 39 45 1 34 27 38 22 15 22 26 21 5 37 4 19 27
17 10 3 48 45 35 48 36 1 32 1 36 15 47 49 43 44 1 27 20 6 28 1 42 1 28 10 31 35 1 1 4 16 1 24 1 29 10 35 1 17 13 34 13 14 36 1 44 13 26 27 1 31 28 37 1 17 8 29 26 1 32 40 1 1 8 1 1 1 15 11 36 26 11 1 17 1 4 13 38 7 19 1 5 1 50
12 1 2 15 35 18 9 50 1 41 1 5 3 1 43 32 45 1 1 1 22 1 42 10 38 34 4 11 38 28 35 46 42 3 6 17 38 1 27 1 37 1 11 16 42 39 36 16 23 4 2 2 21 4 22 25 1 42 5 1 1 46 38 19 3 1 5 16 1 1 48 26 27 26 1 25 23 46 29 19 27 12 16 3 17 23
44 50 35 2 37 1 1 18 1 19 20 1 47 40 1 1 30 28 38 27 33 8 1 47 49 1 1 14 11 9 9 1 1 1 22 24 1 12 38 2 17 1 4 9 40 1 32 42 40 1 5 42 32 36 7 1 1 1 41 47 4 1 34 17 1 40 42 30 44 1 15 1 35 1 27 46 47 49 1 17 33 15 38 46 10 45
14 30 13 26 39 10 1 39 1 1 3 1 11 25 21 30 24 22 42 13 46 26 1 1 22 22 30 26 9 40 44 1 19 24 44 40 1 30 42 20 1 15 11 40 37 25 50 18 14 39 8 28 14 32 1 45 1 1 9 1 12 16 28 7 12 17 42 27 49 1 1 48 30 13 1 25 37 31 31 49 2 5 30 26 35 37
46 8 34 1 9 18 1 1 41 19 43 8 8 22 12 26 27 14 34 15 11 9 1 1 13 5 13 45 29 42 7 8 1 18 34 2 1 46 6 4 13 25 2 30 1 1 1 1 1 5 32 21 1 33 46 50 5 30 13 1 1 30 2 1 10 22 25 1 1 43 1 4 44 22 34 1 7 1 32 4 19 2 16 45 1 50
33 37 47 20 30 10 5 6 9 25 27 43 40 20 35 34 11 1 1 3 16 18 1 1 30 2 7 11 43 21 16 31 26 6 25 2 1 49 15 49 28 1 25 37 48 36 42 32 44 43 46 35 1 44 49 3 39 21 46 1 38 33 1 23 28 39 9 8 1 1 7 35 1 4 1 1 26 45 9 12 3 26 18 29 10 4
27 35 43 33 26 23 6 46 21 36 3 18 1 1 31 6 1 1 1 37 1 18 47 32 5 19 4 9 49 29 21 27 3 12 34 40 35 48 1 16 3 1 1 1 5 19 1 45 11 11 3 21 4 1 11 31 17 1 46 21 1 32 13 1 6 33 2 1 41 4 10 1 7 28 36 1 48 39 32 34 20 26 15 34 8 39
50 1 41 26 1 11 47 38 48 3 10 32 25 36 41 19 15 1 10 18 11 1 1 24 19 48 48 7 14 30 43 1 25 47 34 4 40 1 27 29 1 22 8 10 19 47 19 8 43 42 21 35 18 14 18 1 9 1 12 1 50 1 1 23 32 48 1 8 14 35 1 33 33 10 19 11 35 12 16 1 1 32 1 40 17 32
21 19 48 40 37 37 26 3 46 8 47 41 5 26 1 4 1 46 2 35 39 19 50 22 1 8 39 37 17 21 1 11 50 48 27 29 1 8 17 25 1 28 18 20 40 42 8 41 9 8 4 29 4 12 40 10 33 2 1 15 1 50 45 9 36 50 4 10 11 37 14 42 15 46 26 37 1 4 47 1 49 22 19 38 13 40
1 1 41 35 20 38 1 16 1 1 29 1 14 11 25 17 21 39 1 25 48 24 32 12 19 46 14 9 3 1 16 1 39 1 49 47 41 11 50 5 16 1 37 34 14 35 39 37 8 19 1 50 49 1 16 16 23 1 10 26 38 1 1 22 1 1 39 37 39 44 16 24 19 42 30 4 9 43 7 28 8 3 1 22 17 34
46 41 37 48 35 43 2 24 6 50 37 49 22 39 30 21 49 16 44 1 20 1 45 48 33 46 27 20 3 41 25 28 23 48 31 35 9 2 5 38 50 34 34 28 43 13 1 50 35 27 1 49 21 1 1 11 35 13 1 27 1 10 26 29 49 4 31 48 27 4 10 1 46 1 11 47 1 6 31 30 42 14 48 30 11 1
33 3 1 19 13 16 1 20 1 1 1 45 3 50 7 1 25 36 1 21 13 17 35 32 4 32 12 10 31 3 1 26 27 3 12 41 1 4 42 22 24 32 32 1 1 1 40 17 24 47 1 42 37 1 47 1 1 24 33 47 25 50 6 35 8 42 27 28 14 1 41 43 49 23 23 29 34 20 1 32 38 22 24 1 4 37
46 1 18 2 30 10 47 1 27 30 17 37 17 21 33 46 1 6 1 1 37 38 21 25 48 1 35 8 36 12 32 1 9 1 23 3 27 35 39 23 46 32 1 18 10 40 12 5 13 1 44 1 7 4 22 30 22 42 1 37 41 46 32 2 8 29 24 1 3 8 1 1 1 1 24 14 1 43 1 4 29 1 4 34 33 29
34 49 42 7 45 12 1 1 31 46 28 34 38 1 1 33 36 36 36 12 1 39 1 10 44 36 20 1 1 1 3 1 39 37 36 1 38 25 49 1 33 1 1 1 38 1 22 23 1 1 1 16 34 43 39 47 40 18 3 23 8 29 19 8 5 6 38 49 43 1 44 1 8 27 32 32 6 48 26 47 45 18 1 36 1 34
1 16 1 18 34 1 1 17 26 1 3 39 16 15 26 25 20 1 13 3 41 1 7 47 4 8 1 49 41 22 16 47 19 7 27 23 7 7 40 13 48 36 1 35 34 1 3 17 48 39 40 6 41 23 1 12 29 7 22 46 1 1 24 47 21 3 44 1 36 17 25 10 6 1 38 42 35 1 10 25 11 25 45 21 27 39
16 1 11 36 45 49 1 6 1 10 23 8 39 40 15 49 25 46 2 32 1 39 1 1 22 1 1 30 39 15 29 43 48 12 1 30 4 1 30 34 36 1 34 19 21 29 46 4 43 8 24 16 1 19 14 39 35 18 1 36 3 20 1 44 29 31 5 41 41 43 23 23 3 35 10 19 1 5 3 22 24 44 23 43 42 14
19 36 49 23 1 7 20 1 5 7 37 11 38 10 24 1 40 24 19 1 6 27 1 1 1 42 10 27 30 20 27 40 16 1 33 41 1 21 24 3 1 9 1 1 27 43 14 14 24 1 1 37 19 4 13 49 50 35 11 8 1 37 20 9 1 33 37 16 50 3 5 37 10 21 45 1 40 26 29 1 25 1 3 30 43 47
34 23 44 9 45 48 47 1 22 14 14 1 27 30 23 32 4 27 37 29 28 18 38 12 1 21 1 5 44 29 26 2 16 1 32 29 16 6 33 34 28 2 1 1 31 32 32 1 40 1 10 27 35 40 19 1 6 27 47 20 48 14 10 8 1 1 18 1 1 38 19 37 18 1 30 41 1 12 20 12 47 1 7 30 11 22
34 27 13 5 11 2 46 27 34 35 7 15 9 19 1 1 36 44 41 1 50 1 41 1 47 1 37 1 14 30 50 34 35 9 1 33 1 1 3 32 5 14 50 1 29 1 31 1 33 2 11 26 41 1 39 35 45 26 17 1 1 49 28 24 1 37 44 38 2 42 4 32 13 3 1 32 38 1 38 38 6 1 1 39 1 1
29 1 25 31 25 1 28 48 10 46 34 43 38 2 1 47 49 14 1 1 30 1 1 30 40 5 24 26 7 1 1 20 23 44 20 1 5 1 9 44 48 1 27 20 1 32 41 1 25 46 50 17 4 39 9 41 25 47 19 40 48 6 34 29 13 9 45 42 50 26 23 1 6 1 14 35 31 1 37 30 31 25 31 1 47 19
1 4 20 22 49 5 36 1 27 1 47 43 44 1 31 48 29 38 7 37 44 24 18 37 1 48 28 3 1 9 17 23 1 41 19 36 24 46 30 3 1 46 1 11 4 29 1 22 18 33 3 38 23 46 12 7 1 43 16 40 7 26 42 1 24 1 2 1 14 6 1 8 15 27 15 1 18 10 13 1 37 36 1 42 1 1
1 45 47 44 1 37 1 1 5 43 1 28 1 5 11 22 1 1 16 38 23 1 19 18 6 42 33 30 1 12 29 10 25 1 46 34 20 35 41 1 39 45 47 23 1 5 37 36 44 12 33 36 32 22 1 45 15 41 14 14 10 27 37 24 45 35 30 37 33 28 43 35 47 34 1 46 1 10 5 50 31 1 17 37 24 6
43 1 35 29 44 17 1 49 1 48 27 36 19 29 24 38 15 43 47 43 38 17 14 32 1 43 1 1 48 48 15 49 31 10 29 45 1 1 21 34 20 1 22 22 33 5 10 38 1 13 46 26 13 31 1 10 25 21 1 17 25 26 37 14 1 1 1 14 24 1 10 34 33 2 48 16 30 1 17 31 43 43 3 42 37 22
50 45 46 25 1 1 35 32 4 35 19 34 4 5 1 21 49 44 39 18 1 11 36 35 49 48 15 30 2 42 47 13 41 25 27 1 36 29 28 34 21 1 1 34 18 1 22 1 24 50 3 1 1 30 48 1 4 23 14 1 48 49 44 6 37 48 1 10 1 19 21 1 46 29 14 3 47 1 14 1 1 27 1 49 48 39
48 1 4 41 44 40 5 4 50 41 1 17 41 17 19 1 8 37 25 39 34 1 27 12 1 42 31 30 7 43 1 35 48 12 13 12 1 12 16 10 41 36 30 19 39 40 32 44 9 16 19 27 1 35 15 24 40 34 48 28 5 44 33 2 13 40 10 13 1 1 45 40 20 1 4 1 17 1 9 7 29 35 34 32 47 1
40 1 4 24 50 47 4 5 1 1 46 29 1 41 18 7 3 43 24 45 1 35 30 47 1 30 1 34 48 43 37 31 38 43 5 3 1 13 30 32 28 1 1 18 1 43 28 36 27 46 1 1 1 15 26 30 4 1 14 1 5 20 46 1 9 1 10 36 36 34 17 33 24 6 42 34 25 1 1 7 48 50 26 1 14 1
27 38 1 1 49 8 39 7 11 21 14 13 17 9 44 23 26 34 1 43 1 17 37 33 31 28 6 1 8 1 20 9 18 1 12 14 15 1 50 20 25 1 8 10 40 11 20 1 7 1 1 1 15 5 44 50 1 34 22 40 25 1 50 8 26 35 26 29 1 43 1 26 44 1 26 8 27 14 11 1 13 38 15 47 35 1
31 30 26 44 33 41 1 9 33 38 22 39 41 9 27 22 34 21 15 1 40 24 22 45 15 38 24 1 36 1 26 41 41 25 36 3 20 34 1 13 40 20 41 22 16 25 11 1 9 33 30 40 17 1 23 1 33 47 44 46 1 13 18 15 29 50 14 3 29 46 1 38 17 1 10 38 19 33 1 34 25 1 3 27 33 31
14 39 17 10 40 1 18 1 41 5 19 1 1 47 36 15 1 49 12 12 46 50 48 16 36 12 31 7 1 25 20 8 15 1 2 44 11 45 9 19 18 1 28 17 3 1 49 6 34 1 7 40 3 1 10 24 38 9 38 37 1 35 22 49 32 12 13 31 39 17 23 47 1 29 3 19 1 11 6 39 1 27 1 11 28 1
30 22 42 49 18 22 1 2 21 32 1 1 23 25 1 46 28 1 13 1 43 22 30 23 46 1 22 10 32 8 19 10 38 12 1 21 28 38 1 38 43 46 5 26 41 1 48 33 48 44 35 1 19 33 29 3 42 49 42 5 46 47 49 6 41 17 18 10 1 30 41 1 33 38 1 40 1 21 3 3 45 2 38 30 1 46
34 6 18 33 21 9 1 8 21 5 1 13 9 34 50 40 8 17 43 22 1 1 1 14 13 29 30 14 15 35 50 24 35 1 39 30 5 20 2 1 41 1 2 1 18 44 9 1 49 1 19 34 50 13 38 38 14 1 32 1 1 42 25 33 31 22 38 1 1 8 7 25 38 47 36 5 12 42 39 19 10 1 10 1 48 50
24 3 1 1 21 24 26 1 1 46 17 15 24 3 1 20 44 21 18 19 49 27 7 49 32 1 35 18 35 15 30 45 46 38 48 4 39 9 45 27 36 27 31 42 18 34 35 1 1 1 35 37 40 1 1 1 32 40 38 1 27 41 35 39 42 32 14 33 4 29 1 27 34 21 27 22 40 1 41 1 45 37 48 10 44 19
1 41 35 22 30 19 21 34 6 1 1 16 40 47 13 43 22 23 1 36 1 1 33 1 3 7 1 24 17 30 1 4 27 40 1 33 37 1 46 1 32 1 20 3 41 17 3 28 22 12 45 14 36 36 33 21 26 1 44 35 5 3 1 1 1 1 2 43 23 24 4 39 5 1 28 35 15 48 41 13 1 1 30 1 26 26
1 21 2 18 42 1 27 1 1 45 50 32 18 44 25 1 1 1 2 9 2 47 20 1 36 7 5 1 45 42 6 1 20 12 19 26 14 1 21 39 30 47 16 38 5 2 35 18 1 25 6 48 26 1 46 1 29 14 29 1 35 29 1 18 4 9 34 22 43 1 21 22 1 13 24 3 1 27 34 1 3 23 22 42 14 1
7 23 23 18 37 8 6 12 39 37 16 27 9 1 1 1 37 41 13 5 1 48 1 4 8 48 13 24 32 19 43 41 25 41 28 1 34 19 1 43 24 38 7 1 42 18 27 16 34 32 1 37 45 20 38 14 20 37 27 28 1 49 49 1 32 21 20 30 45 43 1 32 2 11 38 17 27 1 34 14 39 11 1 5 1 1
1 12 1 32 4 1 48 7 2 27 9 1 28 7 48 1 20 12 19 11 33 26 1 13 21 22 19 8 24 1 1 1 26 29 2 1 48 31 1 15 2 8 1 19 12 33 39 19 1 6 48 18 18 34 16 1 5 32 19 22 23 1 1 50 44 1 21 39 33 6 10 23 28 22 46 46 32 37 17 7 41 48 16 20 16 1
1 1 1 24 4 5 44 27 1 47 1 10 1 1 19 15 11 34 39 47 1 29 32 14 1 19 31 50 15 16 8 18 1 29 38 44 9 2 25 1 42 18 1 28 8 26 21 45 6 6 50 1 25 48 1 1 6 1 3 29 1 34 31 1 4 12 1 48 1 22 10 26 13 48 40 33 2 3 9 32 11 4 45 8 19 1
34 28 30 50 7 23 2 23 5 4 1 1 15 1 20 39 13 11 42 45 11 40 1 42 27 11 7 1 46 6 35 11 23 22 21 1 49 10 1 1 1 45 3 17 44 27 39 29 15 1 49 27 42 10 15 1 1 46 4 31 23 6 23 30 1 3 36 17 2 40 8 15 34 19 42 20 14 1 1 26 41 8 1 4 34 14
12 13 47 1 4 3 7 40 16 23 43 27 7 17 13 4 1 19 1 12 1 1 36 32 44 9 20 50 19 6 10 40 21 1 13 11 50 8 37 12 36 1 43 1 1 22 21 1 27 32 1 37 27 7 1 21 23 15 14 1 1 1 1 6 1 39 1 5 41 35 15 47 28 10 7 25 17 3 46 19 42 1 21 1 2 24
32 1 1 35 30 43 14 38 6 38 1 31 1 1 12 9 12 1 12 40 11 27 35 5 32 9 38 48 5 17 13 14 50 1 23 22 25 11 24 50 27 2 47 10 11 40 21 1 50 5 9 17 17 2 41 19 7 28 10 1 24 40 39 1 20 18 3 34 1 5 1 25 1 14 1 13 17 11 17 43 1 1 6 25 40 46
50 1 10 43 10 35 39 16 1 5 1 1 45 36 20 42 1 14 31 21 31 41 50 1 50 22 16 1 1 1 13 1 35 1 1 17 1 25 1 1 12 41 47 11 8 36 21 16 4 11 23 14 14 1 45 1 20 17 6 16 44 9 48 1 9 21 1 44 12 31 6 1 42 1 26 1 1 2 1 1 21 31 7 35 4 1
48 21 46 39 3 39 12 29 45 2 38 44 37 34 32 40 25 4 1 1 1 19 41 4 20 42 9 1 3 9 33 44 31 25 8 1 4 9 1 46 3 1 1 34 29 10 22 1 17 32 1 1 21 43 1 44 11 30 24 29 33 1 4 28 1 31 9 23 1 21 3 48 1 36 37 7 23 26 7 17 22 28 44 50 39 49
2 4 1 40 40 29 11 2 1 3 43 26 43 1 5 8 19 8 28 14 1 33 1 1 41 47 8 37 19 23 30 21 46 32 14 3 39 2 1 28 19 41 30 28 1 1 1 6 49 1 33 30 46 7 28 1 40 41 9 30 26 14 32 49 46 10 24 1 7 4 37 20 34 6 27 42 27 41 1 24 4 1 1 23 28 48
32 15 6 50 1 26 1 1 33 41 1 28 12 2 7 37 1 22 34 1 26 13 43 16 39 13 6 13 1 35 13 6 31 21 1 19 5 1 1 13 18 1 38 24 26 1 1 41 47 47 14 31 1 22 46 1 1 32 5 46 1 1 1 24 20 1 21 20 32 1 1 8 20 1 6 1 32 12 1 47 34 43 48 49 9 31
26 1 21 43 9 2 26 42 11 10 48 23 6 33 1 50 18 11 6 44 41 1 35 42 1 1 24 42 22 26 16 48 24 21 39 18 47 5 49 1 12 50 29 1 4 40 44 41 1 1 13 18 24 11 17 2 1 5 9 29 41 35 1 29 1 11 11 17 9 28 1 5 46 47 50 40 46 12 46 1 4 34 1 1 11 5
5 16 14 18 36 1 19 38 13 7 1 41 1 21 1 31 43 46 5 1 25 13 15 11 31 43 18 1 1 30 49 9 35 2 24 35 13 32 1 29 33 27 4 43 33 35 27 9 1 15 30 12 18 22 25 21 8 1 30 14 46 17 21 45 26 17 31 9 23 32 10 25 44 1 35 46 1 46 8 46 38 37 1 4 1 40
17 43 44 41 43 48 4 32 26 40 41 6 19 24 24 33 1 1 1 16 6 1 11 1 29 35 25 40 50 38 34 1 26 48 35 41 9 25 50 34 36 13 13 25 46 49 12 27 10 22 16 10 1 33 21 7 47 1 50 44 38 31 12 10 1 1 1 1 1 4 18 1 49 34 49 6 38 20 27 37 7 50 19 1 41 3
38 31 15 22 1 25 8 17 1 11 21 2 21 1 1 23 2 9 16 15 50 39 38 34 3 12 32 48 4 27 38 14 11 17 1 26 50 43 41 1 1 27 1 34 1 1 1 38 6 1 1 1 27 44 1 35 1 33 3 41 7 35 47 1 14 36 1 45 6 39 22 1 5 49 10 17 47 17 1 19 19 37 1 1 1 38
1 33 2 1 48 20 34 1 42 11 41 21 33 44 47 47 1 1 27 27 1 38 24 4 35 34 19 39 27 49 1 1 1 28 1 3 43 28 48 44 1 16 14 49 25 12 1 1 36 34 25 1 40 41 8 1 24 1 13 46 9 34 1 27 18 19 2 1 4 30 29 44 15 42 37 1 48 22 22 9 41 1 44 28 1 18
27 35 29 10 35 20 4 39 31 35 16 30 46 1 5 1 20 11 3 46 31 28 1 45 13 4 24 11 1 15 18 1 1 46 8 39 1 15 49 31 35 32 1 36 24 1 14 22 11 3 12 1 1 39 27 1 30 1 47 40 40 1 42 37 1 7 32 35 1 33 1 1 32 22 10 21 41 44 38 29 1 2 21 1 36 1
40 32 33 28 48 27 1 9 1 27 23 43 7 39 48 1 47 1 1 46 5 1 19 16 38 25 41 29 43 43 1 20 1 3 1 6 7 21 1 1 1 1 1 19 17 36 1 50 28 1 1 10 15 1 11 6 24 1 19 18 37 1 41 3 2 39 1 40 49 1 3 1 10 13 26 6 47 47 39 41 27 1 44 32 1 1
35 1 37 18 1 35 1 46 39 40 33 8 13 25 50 14 19 44 12 19 36 18 1 30 37 45 1 26 2 1 3 1 1 29 20 1 29 4 22 3 25 31 25 43 32 12 4 3 21 2 1 3 10 23 1 16 1 1 5 11 1 1 1 31 1 1 19 1 43 33 3 15 1 38 25 35 47 1 15 45 39 47 10 35 30 31
29 15 37 45 38 30 23 46 26 10 40 44 21 1 31 26 3 33 1 10 1 1 17 44 48 48 3 25 34 15 35 8 35 44 49 48 11 19 34 22 35 3 10 47 4 1 26 19 1 19 5 1 47 18 1 1 19 20 2 1 31 15 38 1 25 18 6 1 46 1 11 14 1 30 1 42 37 40 8 8 1 44 47 1 1 1
1 37 5 2 1 1 41 48 23 47 33 6 30 41 1 33 1 1 38 7 1 13 9 1 35 26 1 23 8 13 43 50 36 6 2 11 47 1 20 46 10 24 1 4 34 9 1 4 4 1 48 30 18 40 1 1 19 32 39 7 16 7 46 1 49 32 1 1 13 1 1 19 46 11 1 44 19 27 8 1 46 18 36 49 2 40
44 43 3 25 7 40 16 49 1 50 11 1 28 1 1 46 23 2 10 4 6 32 9 21 31 27 40 46 40 6 25 1 27 26 9 16 15 8 1 1 27 35 36 48 11 44 15 25 1 48 1 1 49 19 16 21 1 1 17 31 43 1 1 1 6 5 44 4 36 1 7 34 25 24 1 8 1 1 28 47 8 13 1 6 39 1
13 45 27 48 29 5 31 17 1 1 33 1 7 3 8 7 11 26 1 11 28 27 22 1 47 26 41 18 11 32 36 39 31 17 44 20 50 1 8 29 1 24 34 40 14 2 1 1 8 1 32 49 44 1 12 1 17 6 11 25 39 25 1 48 27 44 13 28 23 13 50 21 1 36 28 33 37 19 27 44 42 45 1 18 22 35
