23
9 2 15 16
10 47 30 35 9 1 32 8 21 29 21 15 1 8 25 32 1 14 43 39 1 1 44
49 44 2 32 4 46 1 1 47 7 1 1 44 13 6 36 46 45 13 37 37 6 8
28 1 1 1 2 23 42 1 1 42 1 22 33 8 17 1 1 13 25 1 33 16 27
33 1 30 1 19 22 19 1 11 28 44 17 1 46 22 37 44 18 10 1 1 1 1
11 1 21 48 24 21 21 1 32 22 11 4 29 11 14 27 20 32 31 28 3 1 29
9 6 1 1 1 49 10 49 19 21 3 2 42 1 4 2 2 1 1 15 1 43 16
37 50 24 6 41 5 48 18 19 6 1 49 33 10 38 48 20 18 21 5 50 1 12
1 13 1 24 41 1 1 50 25 32 14 29 37 1 16 10 5 20 1 48 20 29 28
30 8 45 1 44 41 1 5 49 26 16 2 2 1 16 24 10 23 1 1 38 26 27
35 1 15 1 40 14 33 4 16 46 1 27 13 8 1 14 38 1 1 1 1 23 3
32 14 19 19 15 1 1 1 10 26 1 38 1 34 46 17 33 1 23 40 35 18 1
1 1 44 1 1 1 35 31 16 33 40 21 26 2 43 23 23 39 38 27 29 35 15
47 16 1 41 33 6 11 46 17 28 15 1 11 37 39 45 13 26 43 1 4 37 4
15 1 1 17 1 40 7 23 50 1 45 12 11 1 32 7 1 49 1 20 3 22 50
1 29 24 20 24 16 9 34 9 1 7 27 36 1 1 50 28 6 15 3 3 1 1
3 3 1 1 1 40 50 15 3 1 29 26 49 32 1 15 25 23 30 1 1 1 1
17 20 34 1 49 1 20 12 27 3 21 19 14 43 1 49 25 35 25 1 48 43 17
37 27 17 8 40 31 34 1 38 23 37 25 1 39 33 8 23 1 6 10 2 11 39
28 1 41 23 8 1 11 40 10 11 17 4 6 36 4 48 1 37 41 28 1 17 48
1 38 16 4 34 42 31 1 1 1 21 17 20 24 42 1 9 22 39 23 43 14 1
10 43 44 35 36 1 1 1 15 25 1 9 1 40 1 47 8 23 37 1 50 48 24
15 43 31 22 41 22 37 29 18 37 1 10 1 23 8 50 7 24 1 20 21 31 1
26 31 13 5 1 1 30 1 45 22 8 29 1 35 23 34 27 17 1 3 16 50 1
