94
85 26 89 53
31 35 37 10 1 50 41 39 1 1 14 1 50 26 17 22 49 5 40 26 1 40 22 31 13 45 40 27 9 31 1 15 1 42 3 38 41 47 16 46 8 36 34 1 1 45 45 1 4 19 48 38 26 1 50 1 1 1 18 2 14 5 22 1 27 21 47 22 1 1 38 44 1 32 35 10 42 27 32 33 24 13 1 16 33 28 7 49 30 1 9 24 50 1
16 8 1 40 1 1 1 1 37 31 31 36 42 1 10 32 1 3 1 40 3 32 16 1 4 39 27 1 7 20 7 1 35 30 32 49 1 33 45 1 21 11 1 40 1 35 41 29 30 50 22 35 14 47 26 1 2 22 9 27 1 24 32 13 5 1 1 17 23 26 1 46 24 41 16 50 1 28 1 1 9 1 7 48 39 9 12 16 28 1 5 1 8 1
19 1 20 24 41 6 44 42 40 39 34 28 30 33 13 5 33 5 1 1 35 27 40 6 35 41 7 1 11 1 1 46 42 4 22 17 1 37 11 48 27 1 27 38 9 34 6 44 1 5 6 17 47 1 14 15 34 33 48 43 35 39 33 26 43 8 1 41 31 1 1 16 16 13 23 22 17 45 1 41 14 6 24 35 43 15 30 50 24 1 1 38 32 45
48 1 1 47 1 1 12 29 46 31 18 28 25 1 1 15 3 1 48 1 1 1 49 21 33 16 42 24 41 39 24 1 29 21 44 1 13 40 11 33 26 37 47 20 40 48 45 50 32 20 33 32 2 4 1 1 2 27 1 13 2 26 1 34 21 4 38 27 41 1 17 21 10 48 19 36 1 38 41 7 2 6 30 1 5 20 3 36 1 17 1 29 1 1
46 50 6 9 34 7 33 17 42 44 19 36 41 43 1 22 18 8 38 33 1 1 46 28 1 1 29 1 14 42 4 19 1 9 1 18 14 21 1 13 17 31 31 29 1 46 9 30 47 30 14 2 5 1 8 1 6 28 18 13 1 13 1 5 45 40 45 30 4 23 1 4 44 25 1 12 30 19 50 26 37 49 1 1 20 7 24 15 1 47 2 1 17 24
35 1 8 25 20 48 22 2 17 43 34 20 1 25 4 9 6 16 18 43 50 48 33 9 8 19 44 29 4 45 16 18 39 1 20 23 1 38 1 5 25 35 41 29 13 1 1 43 47 40 19 1 8 18 32 19 23 48 39 16 50 25 9 1 36 18 19 1 29 47 40 48 46 22 37 1 19 42 42 3 48 4 1 16 20 17 34 7 1 34 1 32 36 37
34 1 30 1 10 5 21 1 38 2 1 27 27 1 1 1 16 1 3 37 32 48 46 41 1 46 30 32 10 50 15 1 45 10 18 23 23 17 48 40 16 1 15 1 32 24 25 46 28 30 27 46 20 12 21 20 16 27 50 1 1 39 5 47 16 16 31 35 32 7 48 30 1 25 26 21 17 1 22 19 43 21 1 45 13 27 20 19 1 26 1 18 44 36
1 14 45 44 19 1 1 21 35 18 28 47 1 1 1 11 1 14 7 48 5 28 3 10 3 33 11 11 25 3 1 48 14 20 13 16 1 7 30 4 24 7 17 8 12 1 19 42 20 39 1 17 25 1 15 1 33 1 1 17 1 17 50 1 1 1 1 14 1 42 32 20 48 1 1 1 25 31 25 40 44 49 18 9 1 33 26 11 28 10 8 26 34 40
1 1 19 47 1 42 44 4 6 7 1 10 6 30 34 1 1 45 44 35 1 1 1 1 28 36 36 18 11 1 32 3 1 33 41 26 20 1 9 13 21 1 16 1 40 13 29 17 34 25 48 2 1 32 33 33 49 18 7 8 33 25 2 43 4 33 36 45 38 1 1 41 32 31 3 49 11 28 1 17 39 45 1 28 1 1 27 17 1 37 15 21 1 33
29 32 19 24 29 1 4 11 21 1 1 1 37 1 6 1 36 6 14 19 42 20 9 41 43 23 1 25 19 26 39 27 23 1 1 1 14 1 10 29 41 20 37 14 46 50 39 4 24 7 5 1 13 30 3 43 35 1 3 17 1 32 37 23 47 13 25 35 28 3 1 34 45 1 31 21 17 14 49 17 24 39 33 37 10 1 1 47 23 1 23 32 29 1
33 5 4 3 2 1 10 9 37 36 21 20 30 2 39 16 1 10 13 23 2 30 1 29 49 22 37 1 1 39 44 8 24 1 25 36 47 1 18 47 21 1 36 41 43 30 1 35 1 33 34 1 43 27 23 45 50 39 1 29 2 16 6 1 28 1 12 13 5 48 21 1 34 4 1 44 16 13 1 23 38 1 1 1 44 18 6 1 1 1 23 23 1 1
23 1 39 42 22 15 1 41 1 17 4 1 1 41 15 45 33 1 7 1 26 31 28 1 2 27 20 31 12 47 9 1 1 14 44 29 18 40 35 10 22 1 46 48 4 7 4 38 38 34 7 1 12 1 2 18 22 26 43 17 31 17 1 1 1 20 38 1 7 25 6 2 21 15 33 1 20 21 41 40 1 42 10 39 22 33 1 18 47 23 1 43 1 8
1 4 1 37 37 47 5 44 1 14 2 22 1 27 29 1 38 35 44 30 2 1 46 36 15 36 27 11 35 28 1 41 39 1 26 42 47 1 36 6 41 20 36 12 15 1 1 1 34 1 22 13 32 1 43 34 4 39 28 14 43 24 1 7 44 30 20 41 15 43 39 17 40 1 37 1 32 43 50 37 24 48 49 30 12 13 11 1 26 40 35 33 6 3
36 8 21 35 42 36 1 46 4 1 15 6 4 44 31 17 3 35 14 26 24 1 1 16 27 17 1 6 27 37 45 44 40 46 37 40 16 49 14 38 1 41 1 43 1 12 47 17 44 40 47 49 43 4 8 46 13 33 32 47 20 33 13 13 15 12 19 32 1 6 20 45 10 31 1 42 46 45 16 22 33 8 31 4 8 41 36 44 49 23 43 27 26 46
2 14 5 47 45 11 2 41 31 37 42 1 1 39 17 14 2 1 9 8 2 12 48 1 42 49 40 45 38 28 32 4 48 1 18 1 30 33 7 34 1 1 2 24 19 49 16 11 25 6 1 7 19 1 11 23 1 25 27 1 31 30 50 2 15 25 46 1 42 48 47 5 15 35 12 49 15 2 28 1 31 1 18 1 1 1 18 1 38 41 5 6 11 1
1 15 24 18 22 26 31 17 32 42 20 30 44 23 26 14 16 2 3 1 16 35 36 1 38 1 39 1 50 50 45 1 9 9 1 24 21 1 2 31 1 1 16 1 45 33 2 12 1 26 14 35 20 1 6 1 18 46 1 8 35 23 47 5 14 14 24 9 37 5 39 13 23 45 45 17 11 8 9 1 19 1 41 28 1 14 11 34 32 7 35 43 1 37
4 30 1 22 1 9 28 23 34 14 1 43 20 18 47 7 6 30 1 1 31 49 41 16 42 7 10 21 29 19 28 1 1 15 29 15 42 11 41 16 41 1 7 1 19 16 23 1 5 1 1 34 1 1 46 11 18 10 26 7 4 1 22 7 16 25 40 19 3 45 30 46 21 29 16 45 37 48 6 5 19 2 13 15 29 34 8 39 40 11 25 29 25 16
17 44 43 17 25 14 24 30 1 1 1 32 1 48 47 1 5 1 1 47 12 1 41 8 1 18 17 44 29 39 20 27 47 45 27 34 1 4 19 1 41 42 36 16 4 28 4 3 22 1 4 1 48 1 31 28 28 8 38 12 29 38 18 24 9 5 2 1 1 33 31 18 46 4 44 48 35 22 42 1 5 42 20 19 1 43 22 1 1 17 50 36 1 36
1 46 24 1 47 19 1 43 22 12 30 50 1 3 10 1 48 12 8 38 33 25 26 40 49 8 21 34 1 6 40 27 33 26 30 34 32 1 1 1 22 1 11 18 4 20 1 1 29 1 42 1 26 32 21 1 11 19 1 14 48 38 1 11 36 1 10 48 3 3 39 30 35 17 42 48 1 40 1 17 32 1 40 7 13 3 4 12 8 16 16 5 35 1
33 15 41 30 22 9 13 44 39 4 1 1 19 14 48 49 14 16 32 38 1 1 1 16 18 50 13 1 1 13 48 8 21 40 1 22 20 9 4 1 13 3 27 30 23 43 25 13 41 28 5 34 43 24 49 16 26 12 45 1 1 1 34 11 41 9 1 36 47 36 41 43 28 24 26 30 39 43 2 1 47 46 38 1 1 37 31 1 12 37 1 34 46 39
1 37 37 1 22 42 24 42 1 24 20 20 15 18 41 1 31 40 11 1 1 20 2 5 34 48 21 1 8 27 34 44 1 22 19 1 32 11 40 1 45 18 30 37 1 23 9 49 45 41 11 30 10 1 22 1 15 42 49 43 49 46 35 40 42 1 6 1 8 6 45 24 39 4 6 12 12 47 17 12 15 7 1 1 1 1 3 43 1 1 1 25 23 31
24 47 49 1 28 8 1 1 22 18 1 1 1 30 7 19 24 47 24 1 50 1 12 50 23 8 25 44 1 12 28 30 39 1 36 1 5 1 30 15 13 28 25 32 37 21 22 1 8 6 28 45 41 47 29 13 36 18 36 43 46 6 48 47 31 5 1 40 48 1 1 6 1 45 21 40 22 45 8 37 10 9 43 9 1 1 1 33 50 4 19 1 20 50
1 34 48 22 28 16 14 12 42 33 39 1 42 1 10 8 24 1 19 30 6 40 45 42 8 1 1 1 30 1 26 13 43 17 43 1 9 46 12 7 35 24 40 28 1 1 34 35 15 7 38 1 49 15 26 24 3 41 39 36 14 27 46 43 28 17 8 44 32 8 42 2 10 1 1 10 44 1 44 20 16 1 11 1 1 1 47 1 35 1 1 5 30 7
50 15 34 30 23 44 30 28 1 22 50 4 20 13 50 22 41 28 8 1 1 24 19 15 1 6 10 28 34 1 28 45 1 38 48 2 40 42 39 8 1 25 42 25 1 42 2 34 1 46 46 44 1 26 3 10 23 1 31 3 10 2 39 1 5 20 34 18 1 1 1 1 46 22 1 43 11 1 14 4 24 48 19 16 1 1 29 37 1 19 10 22 19 15
4 12 1 19 7 1 33 19 16 1 5 1 49 41 47 1 32 1 29 43 24 6 47 27 26 1 49 28 27 1 1 26 17 1 1 14 26 50 20 33 30 33 35 28 11 30 33 1 10 16 3 40 21 48 1 10 28 23 26 1 7 6 29 11 7 2 45 23 8 1 22 2 16 41 38 1 1 24 1 36 19 24 16 39 8 37 23 16 38 45 31 30 7 9
2 7 44 8 24 4 14 1 8 45 1 46 13 48 15 5 44 8 1 12 39 2 33 1 1 22 50 12 37 47 5 18 33 1 21 30 32 13 1 31 1 1 31 49 1 1 19 15 48 1 1 26 21 43 45 7 13 19 41 46 25 35 23 28 1 20 29 11 29 14 46 6 28 1 1 35 33 5 20 2 1 30 1 6 5 1 21 5 1 49 43 50 44 40
39 33 22 27 1 1 1 1 3 1 5 17 7 48 39 21 47 49 15 45 13 8 47 25 13 40 1 41 1 13 1 33 25 42 46 27 10 5 17 15 44 14 1 1 46 39 37 29 26 48 9 14 3 16 40 36 1 17 49 44 49 11 1 39 7 1 47 3 28 12 6 32 15 1 27 9 50 7 27 9 45 28 17 12 40 23 21 19 20 28 47 2 38 22
4 26 11 1 1 3 3 42 1 1 38 1 50 2 2 21 36 29 47 1 41 21 1 1 15 19 18 1 50 1 38 24 29 20 1 7 44 10 24 25 27 36 35 37 15 36 11 4 37 45 12 39 1 1 25 27 15 15 44 1 1 44 37 14 21 21 46 9 19 47 5 1 37 1 8 29 45 29 41 28 23 1 38 1 20 35 1 48 48 1 19 32 7 44
1 3 5 1 35 46 14 9 3 1 1 3 7 1 1 22 35 37 1 39 30 1 44 1 25 49 20 34 20 34 44 19 47 11 1 22 48 47 1 27 35 1 9 48 21 1 14 1 26 41 19 11 42 47 35 39 21 29 27 41 15 49 44 20 30 1 30 34 45 34 2 37 3 1 1 45 42 1 7 1 5 44 13 1 44 23 2 11 50 34 29 32 1 1
22 9 41 34 42 1 1 1 1 45 37 1 1 29 37 19 13 40 20 34 2 44 15 13 18 39 28 19 10 1 1 45 42 4 6 10 1 1 48 1 29 18 11 28 35 20 35 13 42 1 1 1 29 27 31 46 49 4 1 28 1 14 1 1 41 2 4 29 8 34 37 19 25 1 32 8 5 36 1 30 1 1 1 23 44 26 10 13 4 32 29 15 37 38
50 1 31 4 1 8 1 1 47 15 39 36 13 49 7 1 10 28 33 1 37 1 9 31 9 19 18 1 24 50 1 25 26 12 49 29 50 43 18 1 25 16 27 40 20 4 47 1 38 39 36 7 1 20 17 8 10 49 2 10 14 46 20 19 19 1 17 12 1 7 40 1 42 24 6 24 4 27 32 16 38 1 1 47 11 36 1 1 34 2 1 1 36 18
50 26 41 30 33 40 35 2 31 8 9 27 1 3 1 8 46 23 3 28 1 46 1 36 1 22 27 1 20 40 28 1 1 48 33 7 27 7 11 49 40 33 27 1 1 48 22 38 41 33 6 7 1 1 13 1 35 1 9 16 1 14 9 23 28 1 2 45 38 16 1 16 10 11 1 40 7 47 32 10 44 38 39 34 21 41 8 35 1 1 13 30 18 16
28 38 1 1 25 36 35 7 31 1 1 29 49 14 25 45 44 40 1 38 2 40 23 45 1 32 15 40 13 1 36 32 16 45 1 7 42 25 25 1 32 1 43 7 1 1 1 31 19 17 1 22 19 1 45 1 1 30 29 36 1 7 26 8 15 1 1 2 50 24 19 5 42 46 2 1 37 30 26 1 40 1 1 37 43 28 25 3 35 1 46 26 1 32
42 7 1 1 2 1 5 16 22 22 20 1 1 2 1 5 35 41 43 38 25 5 7 38 1 5 22 35 7 48 1 19 1 38 18 28 28 15 18 18 1 24 47 1 32 49 26 43 44 1 1 28 19 1 1 18 18 24 41 24 16 17 1 28 16 21 50 3 25 24 50 21 1 15 20 21 40 48 1 13 1 33 4 1 44 1 16 23 48 39 1 38 1 36
19 13 47 3 1 45 34 34 45 42 9 8 37 16 45 5 15 48 31 41 1 11 29 1 4 1 16 1 8 11 22 1 15 13 47 4 49 37 1 14 14 43 1 42 1 46 9 1 23 1 12 1 7 7 25 37 27 17 1 7 46 22 43 31 1 30 48 45 37 29 31 1 1 47 1 20 16 1 30 41 1 17 49 6 11 18 35 4 35 48 42 1 29 43
47 46 1 50 42 38 10 2 26 1 1 1 1 39 44 1 8 27 39 1 6 39 6 29 14 25 42 49 13 15 18 30 1 2 45 21 11 16 13 45 48 25 1 19 35 43 31 43 3 42 37 21 1 1 1 38 17 4 11 1 31 32 47 1 22 44 23 44 42 28 1 1 1 2 1 15 41 25 30 50 9 1 30 5 14 44 34 1 1 49 14 27 24 39
29 1 1 1 48 21 1 39 38 46 35 17 16 1 14 4 17 1 1 18 12 2 10 49 1 50 1 18 1 14 11 11 21 14 35 35 24 46 10 1 30 29 34 1 1 1 14 21 40 14 1 19 41 1 15 1 1 42 25 1 1 30 44 12 39 43 1 1 26 1 42 35 16 1 23 29 41 1 1 13 46 1 1 1 50 27 48 28 33 1 1 1 1 1
9 1 34 36 11 13 5 39 7 1 22 9 1 4 8 36 1 21 49 24 25 41 27 37 34 17 46 45 15 36 1 1 13 25 46 41 45 33 27 15 38 9 30 22 6 1 40 19 1 1 41 28 24 11 12 48 44 18 6 32 32 1 32 30 1 36 1 10 3 1 20 31 35 1 50 1 9 42 18 16 1 30 22 16 8 11 44 46 1 1 1 48 1 34
15 10 47 2 15 7 30 4 34 19 1 38 1 10 19 1 39 1 1 15 33 21 23 47 11 1 10 23 6 26 22 43 12 50 24 38 18 1 27 42 9 28 1 26 1 34 16 15 36 15 34 21 46 1 39 25 30 40 48 1 35 47 2 14 37 23 9 46 14 1 30 16 27 13 26 22 3 40 21 24 12 17 39 36 37 42 1 1 45 5 31 32 30 1
43 28 1 9 33 17 40 1 1 30 20 21 1 5 10 12 41 44 1 28 16 48 10 1 1 1 7 1 1 50 48 11 43 35 1 30 13 26 11 38 1 5 11 49 29 14 26 31 46 33 37 17 28 24 43 16 47 6 48 1 44 38 1 17 29 1 1 47 1 20 1 1 14 1 1 23 29 21 1 4 4 36 19 39 46 48 1 38 1 28 1 44 10 6
44 26 27 1 21 1 1 50 6 34 50 17 1 1 2 8 1 1 1 1 37 24 36 35 1 19 45 1 1 1 43 19 28 5 14 6 16 45 10 31 14 1 14 12 34 36 18 11 1 1 3 31 29 1 34 1 41 32 34 11 26 43 28 1 49 12 8 19 46 29 6 39 21 37 1 1 45 13 19 26 22 27 4 1 17 37 16 42 35 14 20 19 1 35
27 48 1 41 11 20 10 17 3 23 19 1 1 1 1 36 13 41 10 21 5 47 10 34 2 47 1 45 13 42 31 29 42 10 22 16 1 21 1 17 39 1 34 6 18 2 25 1 14 31 47 14 41 3 1 37 14 24 1 1 40 1 15 29 50 27 40 28 4 1 1 3 1 33 39 45 49 16 47 8 45 42 27 1 1 24 13 39 20 35 21 1 43 11
6 8 34 1 18 11 22 11 6 20 1 37 3 48 1 9 1 19 9 9 35 23 18 1 1 44 1 1 36 39 31 8 26 42 21 36 6 42 22 1 23 28 35 31 1 1 35 7 24 1 25 31 1 48 33 1 48 42 32 32 3 21 9 19 14 24 38 40 1 17 5 36 4 2 36 18 37 1 1 48 17 50 47 45 1 1 48 18 50 1 1 1 14 9
27 13 28 20 1 39 49 4 20 40 1 33 1 32 1 24 27 24 31 22 48 22 19 42 5 18 2 12 10 36 39 30 10 31 1 7 1 1 1 1 1 9 23 28 5 16 9 19 22 1 7 40 41 1 22 28 1 36 12 6 32 40 48 5 49 4 1 18 37 49 44 21 45 26 9 21 30 44 1 2 22 33 13 31 14 24 38 1 47 14 35 7 4 1
12 45 23 48 47 21 3 9 15 24 1 28 36 6 1 1 15 45 27 28 13 8 35 1 21 8 27 12 12 9 4 9 4 38 44 41 43 1 1 3 25 8 1 1 21 30 24 5 2 29 17 25 5 17 17 1 45 19 48 44 1 25 1 1 35 40 29 5 13 33 7 20 37 1 10 41 1 33 25 47 1 36 35 13 1 2 49 23 33 27 35 12 34 24
3 41 17 49 1 20 1 48 32 47 5 2 38 18 49 48 35 1 7 1 3 41 43 26 35 31 36 11 35 1 1 8 1 9 29 1 47 28 28 45 14 28 20 17 36 21 1 4 18 41 15 23 1 31 50 1 15 1 43 46 20 30 45 7 1 38 1 10 11 1 36 2 1 1 1 26 23 48 1 46 24 33 7 22 1 49 18 1 1 47 21 26 49 22
18 24 18 28 1 10 46 44 35 36 1 16 1 31 1 22 28 13 1 10 36 6 43 20 44 35 37 13 45 10 40 46 14 33 29 14 50 15 2 35 1 1 2 9 4 38 1 17 14 23 8 23 18 22 6 1 30 21 17 1 42 33 3 10 17 1 1 1 19 31 48 9 30 36 24 1 14 42 29 11 1 31 21 36 1 11 5 11 1 37 9 34 19 20
3 22 41 1 18 16 1 46 31 1 10 18 1 12 16 19 1 29 22 30 19 9 1 7 7 32 20 43 36 7 46 1 10 40 1 1 1 12 45 18 36 5 35 33 4 11 33 31 1 5 36 23 34 42 9 34 22 48 37 9 31 20 18 33 1 40 1 32 3 8 1 32 38 50 14 46 23 46 40 17 8 42 49 26 4 29 17 35 22 27 16 35 22 23
1 1 20 48 12 24 18 14 40 1 11 1 1 30 3 22 18 48 21 14 14 29 7 1 28 3 35 1 12 45 1 1 12 5 29 46 49 9 15 50 45 1 11 24 13 41 3 11 2 2 11 12 1 1 30 5 32 8 8 19 48 1 14 48 9 4 49 1 29 22 27 7 45 6 30 1 43 4 15 33 22 18 9 49 6 18 39 29 9 1 1 12 9 8
19 1 7 21 24 4 29 4 38 38 31 27 1 37 50 26 43 1 42 49 40 22 1 25 47 1 1 27 36 21 1 1 38 1 13 1 6 1 48 12 35 17 16 25 11 1 29 28 10 27 40 36 21 1 13 1 41 1 39 47 1 35 48 17 27 44 32 42 1 7 13 1 1 50 1 44 25 38 23 1 42 16 32 44 19 1 14 9 13 50 1 14 46 41
30 8 31 28 10 1 12 15 25 16 1 35 4 22 41 40 18 49 41 18 1 10 48 1 1 43 26 33 12 36 39 11 3 11 13 1 12 45 8 34 1 3 42 11 7 47 9 50 3 49 45 1 1 1 32 2 12 22 1 44 44 1 1 1 37 43 22 12 1 15 48 1 6 28 48 26 27 26 14 23 16 34 47 5 35 1 1 1 18 36 49 43 40 33
1 1 39 31 47 2 1 41 22 35 17 17 1 35 15 44 1 12 31 35 8 4 19 1 46 12 46 41 1 1 13 32 12 1 1 43 47 24 8 2 2 50 27 27 45 8 1 33 39 36 16 4 19 1 23 38 23 43 46 1 22 9 26 1 39 22 27 1 34 46 1 41 34 1 1 46 46 21 42 42 17 1 12 38 23 2 26 1 36 8 35 33 6 2
29 4 1 50 1 47 1 23 39 44 1 25 11 16 23 31 29 43 46 31 1 18 32 14 33 21 26 46 20 1 19 27 7 33 18 1 49 5 33 7 32 1 45 5 6 24 41 46 10 1 2 41 39 1 1 31 17 1 24 36 33 1 1 27 1 1 23 28 46 40 24 1 9 1 12 43 27 34 49 45 18 46 38 35 1 47 41 25 41 35 22 46 2 8
30 37 48 24 33 14 49 20 27 4 38 39 32 33 15 11 46 37 8 1 35 1 11 12 8 5 36 1 4 1 2 32 1 29 16 17 11 1 1 5 2 46 1 21 1 8 1 25 1 1 18 29 8 41 48 17 16 24 38 6 48 1 3 14 17 41 22 1 14 30 2 8 1 31 50 35 1 37 13 1 12 43 5 39 47 16 5 20 9 37 1 41 1 2
1 41 46 44 22 1 1 48 20 20 39 1 32 35 1 7 33 19 36 40 31 1 40 36 9 48 1 24 12 1 35 29 13 37 41 1 5 23 23 32 21 45 43 30 7 18 1 35 21 1 44 1 13 48 8 39 9 4 13 11 1 21 23 9 35 17 1 50 1 25 9 6 2 33 7 31 5 1 48 13 46 6 41 31 34 46 1 17 41 1 1 2 3 37
38 46 32 1 29 41 16 1 15 4 1 1 7 35 18 30 39 2 1 20 35 1 38 29 1 24 41 23 38 1 1 20 4 50 35 18 12 4 16 5 18 2 25 49 20 28 1 4 18 1 42 13 1 47 35 19 16 39 19 50 1 1 17 12 1 1 34 30 2 17 42 1 1 6 1 1 1 43 22 1 20 29 17 1 16 21 41 3 25 38 49 1 1 32
44 47 12 7 1 12 44 43 4 27 20 12 44 1 24 44 44 16 46 7 46 8 30 47 43 2 24 1 15 16 36 41 50 39 46 2 40 38 5 50 14 47 24 16 1 1 18 10 7 45 13 1 43 35 39 15 1 1 1 15 43 1 30 15 32 1 14 34 48 8 30 37 33 47 1 14 45 25 5 2 38 3 1 10 21 5 12 1 33 1 1 39 36 7
1 8 21 47 35 1 6 8 15 19 14 22 26 28 1 14 50 1 45 29 1 40 43 10 9 1 44 1 3 18 49 38 1 50 22 1 1 11 39 14 1 39 26 17 42 1 1 42 1 19 1 21 1 1 40 1 1 15 29 33 5 43 50 1 11 6 37 2 1 35 1 43 1 31 33 7 1 13 1 1 12 14 23 40 3 42 41 48 1 4 1 16 35 1
2 6 37 24 19 43 38 50 21 24 25 1 2 23 30 38 12 31 18 1 45 19 1 35 17 37 32 8 27 48 50 1 1 6 1 35 48 1 21 27 29 17 42 42 1 1 34 41 27 1 1 38 29 6 43 18 17 9 1 1 11 1 1 1 22 40 24 26 39 15 1 32 30 26 50 44 35 1 42 4 44 43 1 21 1 11 21 3 45 1 34 2 36 1
38 48 36 25 49 21 1 46 26 38 45 22 12 8 42 18 49 1 48 1 25 1 29 27 39 45 35 1 1 26 14 18 14 7 12 33 39 43 40 23 17 38 1 1 25 37 44 28 14 20 40 26 30 41 20 21 20 37 1 1 5 23 27 33 18 46 22 3 36 1 26 26 28 10 45 30 1 20 12 11 35 4 27 11 18 2 23 43 1 3 26 23 43 20
12 21 24 22 23 24 39 25 1 1 1 7 48 1 6 1 17 45 41 1 13 25 29 33 26 3 14 1 1 21 1 44 33 13 29 38 48 46 29 10 50 48 6 10 35 43 35 47 18 49 5 49 15 26 1 36 6 34 8 40 49 13 1 1 10 47 34 42 46 1 22 25 1 11 29 8 31 1 10 5 19 41 26 8 1 15 30 3 26 30 42 1 29 1
1 1 3 16 1 37 1 5 1 11 29 13 46 25 12 14 26 35 50 19 6 20 17 38 1 46 28 1 14 14 24 27 30 17 4 26 24 1 49 50 33 23 49 1 28 33 46 31 1 34 5 28 33 29 49 5 1 1 13 1 35 5 16 26 1 22 1 48 11 2 49 49 26 27 36 19 46 37 9 18 23 19 1 36 22 8 49 24 1 43 15 1 5 16
1 22 1 1 3 1 40 1 13 17 1 7 33 1 11 42 48 28 1 14 33 34 1 47 2 14 5 40 1 38 1 23 3 19 48 25 9 2 21 38 48 39 1 19 45 31 44 37 28 1 38 13 1 1 24 20 1 31 1 3 27 1 1 49 4 1 20 1 10 1 34 30 1 9 29 4 21 44 1 8 46 44 13 30 40 1 48 2 1 38 1 1 1 1
17 22 36 14 46 18 1 43 50 3 45 36 8 26 35 8 48 44 1 2 47 9 41 1 9 8 2 1 46 9 1 46 49 36 44 1 10 44 13 32 9 22 22 29 19 41 41 5 23 21 2 12 1 1 31 43 17 14 36 17 16 1 1 1 10 16 23 37 10 1 26 9 8 18 23 1 34 26 1 18 3 26 34 1 42 1 10 40 8 45 45 28 34 36
1 4 1 32 30 5 30 50 1 29 4 32 1 2 44 1 1 38 30 46 1 1 1 41 36 1 35 10 37 41 42 46 1 18 36 6 44 49 33 20 42 19 28 1 13 25 2 32 1 1 15 10 13 48 10 12 3 43 5 2 25 11 22 10 48 10 25 21 36 28 26 50 1 41 45 8 4 35 20 18 1 24 1 31 29 17 6 1 1 12 38 1 38 5
32 41 34 34 39 34 7 21 25 1 46 19 9 38 47 25 30 26 46 47 48 26 14 29 38 10 1 16 1 50 23 1 35 46 13 34 45 15 16 8 9 16 1 27 39 44 16 42 25 23 15 26 9 1 49 49 39 1 26 1 3 50 2 38 35 41 37 1 38 32 49 36 1 44 6 11 8 13 7 6 1 20 1 15 32 1 37 33 1 42 25 37 36 45
28 21 40 1 39 17 27 2 30 11 30 16 9 35 1 6 39 3 41 50 7 5 50 6 50 1 45 6 36 6 32 49 34 42 1 13 35 39 35 50 18 3 8 1 1 46 3 4 9 50 1 32 6 32 6 49 1 1 24 17 34 1 7 33 1 17 47 27 21 1 1 26 23 1 33 11 1 37 1 42 7 1 1 1 47 4 20 37 1 1 20 1 50 13
14 38 17 46 1 9 26 1 10 50 45 2 46 39 16 6 1 10 1 20 7 47 1 9 15 26 1 8 4 45 17 1 1 30 1 11 47 1 38 8 37 29 1 14 47 21 49 1 1 2 1 50 36 25 20 37 46 21 1 38 6 28 23 45 20 44 50 20 11 32 1 15 19 16 14 1 27 37 11 1 13 25 11 2 18 1 3 24 24 26 30 1 1 1
31 2 3 30 1 15 1 33 1 1 32 1 1 1 28 3 33 1 50 27 1 15 1 33 41 29 1 41 3 1 6 1 25 32 16 18 13 30 28 6 22 16 40 8 1 15 35 33 1 47 45 1 1 28 30 50 29 25 45 10 36 7 5 33 4 11 45 41 14 25 21 25 4 20 11 13 18 14 28 1 1 12 44 48 1 11 1 2 1 16 28 13 49 14
37 1 41 1 6 39 4 6 20 43 46 1 18 30 34 1 32 2 42 11 3 1 8 6 22 38 42 1 20 13 1 1 49 8 42 1 1 39 29 33 42 23 1 35 4 21 41 50 25 47 4 19 1 19 47 1 23 1 50 6 44 34 14 1 12 28 36 6 9 1 37 48 1 36 48 49 41 36 14 27 35 25 21 22 22 24 3 47 22 2 16 1 13 18
22 46 27 25 1 1 9 40 1 1 7 44 1 13 3 1 39 38 17 27 1 27 8 22 45 37 15 43 1 5 1 47 5 45 16 50 37 47 31 36 48 17 1 4 14 36 49 22 10 41 7 33 1 25 18 1 20 10 49 50 46 1 29 1 1 1 1 39 39 24 1 28 1 14 23 50 50 1 31 21 1 1 36 1 1 8 26 10 30 37 6 33 15 7
1 1 4 45 35 1 1 13 45 48 4 32 1 24 20 10 1 25 34 39 45 16 1 34 1 1 1 1 1 33 11 9 32 41 26 26 26 42 34 11 1 14 9 12 25 38 31 26 31 1 22 5 30 19 20 50 4 26 46 1 36 43 30 25 12 12 1 14 50 10 21 6 2 36 20 34 2 27 49 48 7 1 13 1 1 1 12 48 42 28 2 1 41 24
22 34 1 24 50 44 16 40 27 10 1 1 1 29 1 48 13 47 34 26 7 35 28 1 41 1 1 35 1 4 1 1 32 47 1 47 18 1 16 47 44 36 18 12 31 30 43 36 36 11 42 20 31 44 20 39 20 43 2 48 1 1 5 32 7 11 21 32 26 24 48 45 34 6 45 4 26 4 23 38 21 24 5 28 48 1 46 22 40 1 1 17 1 1
12 35 8 5 15 1 1 46 37 13 45 3 4 1 1 49 8 39 23 26 33 26 24 1 27 1 45 20 6 21 28 1 4 22 25 10 1 29 29 24 1 24 12 1 1 47 1 24 1 47 4 23 1 1 23 28 18 29 1 8 43 22 35 11 9 1 45 1 36 32 10 43 16 1 49 35 25 1 1 1 20 20 9 15 13 42 1 9 1 34 2 37 34 9
49 25 31 44 10 13 14 41 8 1 26 29 1 1 1 10 16 27 33 47 41 1 10 26 4 1 34 33 1 50 19 1 4 10 15 28 29 1 23 30 26 39 7 10 1 33 1 21 26 4 20 1 37 1 11 1 34 2 2 1 1 38 1 21 1 22 1 1 12 39 11 5 40 32 1 14 19 40 1 5 49 15 1 1 9 17 19 2 46 15 48 43 43 21
1 25 32 33 1 35 21 38 8 46 35 15 9 1 1 1 33 1 29 16 22 44 41 23 6 19 1 8 48 9 5 1 1 8 7 13 16 7 6 37 15 49 30 1 34 15 45 42 1 48 1 40 22 11 11 6 24 50 5 25 39 18 1 26 6 44 14 36 1 24 40 10 34 33 38 17 18 33 1 19 15 16 49 47 40 22 12 18 1 35 23 1 10 1
1 1 32 35 27 31 43 1 37 5 1 48 45 28 16 37 1 23 1 19 43 1 40 21 20 9 15 46 16 16 35 47 11 19 39 8 29 28 34 1 42 16 38 13 26 1 34 1 1 1 20 13 22 1 15 49 13 1 18 1 9 33 3 1 21 1 1 4 23 26 1 22 24 8 13 1 29 1 1 34 1 10 13 33 1 36 47 1 18 11 24 3 24 1
26 1 1 21 1 1 21 33 15 1 1 43 1 1 27 41 47 9 1 9 3 1 31 1 15 32 29 16 34 44 38 31 37 37 6 20 25 11 44 49 45 40 31 24 26 46 28 24 37 26 14 1 39 1 42 35 22 1 16 48 19 37 43 1 5 19 31 48 9 1 1 49 1 24 1 28 1 10 1 34 13 43 1 40 19 37 7 40 20 34 24 47 6 44
1 1 1 11 19 1 16 45 48 2 18 50 1 1 39 1 43 1 22 35 4 10 37 1 21 1 38 20 14 11 16 39 35 1 27 39 18 33 17 7 48 47 2 19 1 1 21 26 2 1 48 7 42 36 19 25 13 1 1 30 13 30 1 30 1 35 1 42 1 27 42 7 21 1 42 1 1 14 1 1 6 11 31 10 1 38 25 42 43 9 20 1 1 6
40 28 24 25 27 1 26 24 9 8 37 18 45 15 1 4 16 15 43 1 1 1 29 1 7 36 12 39 46 31 29 42 33 3 34 42 9 1 28 1 3 29 41 45 15 45 1 23 1 1 1 26 26 1 44 46 30 7 18 28 1 18 19 35 31 47 8 46 6 1 1 1 28 47 46 50 22 25 36 40 22 1 17 1 11 5 1 43 28 16 4 11 41 1
10 1 5 1 1 1 1 1 36 22 1 5 1 38 15 35 42 13 1 46 4 18 1 19 24 2 17 5 16 1 28 32 31 46 22 18 25 1 16 1 6 40 1 40 30 4 1 31 46 45 1 36 6 48 21 5 29 36 44 48 27 30 20 43 2 11 38 23 13 33 46 47 43 1 1 7 1 1 1 1 1 48 18 37 14 35 50 43 24 39 28 1 21 22
34 10 1 1 45 34 1 10 12 1 10 1 1 22 2 31 1 28 33 39 4 1 44 7 21 7 44 41 17 37 29 1 6 40 23 22 23 25 37 29 9 48 23 28 35 19 44 9 10 1 30 19 36 1 14 36 25 9 41 1 45 21 6 28 19 1 29 1 50 5 1 33 48 8 1 7 18 1 28 1 28 10 33 1 16 44 1 14 46 10 33 38 30 1
1 1 17 1 30 33 35 21 7 3 1 3 9 42 44 37 14 45 25 23 43 11 5 1 8 29 17 8 1 19 15 21 50 1 13 50 1 13 33 1 36 23 1 22 28 38 1 9 7 26 44 40 46 47 35 40 45 28 13 22 29 21 44 33 4 13 1 28 1 11 10 29 45 50 1 39 1 27 40 1 48 42 1 4 1 17 1 39 1 43 1 18 18 21
31 1 11 26 16 1 29 1 19 17 1 1 33 25 29 21 1 40 35 12 21 34 1 1 4 1 1 33 18 2 9 19 35 39 20 1 35 33 7 7 50 37 36 9 20 1 17 19 12 26 27 48 1 4 11 23 39 38 35 19 23 21 33 1 17 21 29 1 27 39 46 1 1 50 16 24 1 44 35 1 47 44 29 38 11 11 1 1 1 13 49 48 47 27
50 30 2 1 2 1 18 16 33 28 1 1 39 37 43 1 1 7 41 49 31 29 19 14 48 9 1 24 37 36 49 38 1 9 20 1 35 7 16 25 26 1 47 1 33 3 19 9 34 12 1 1 1 48 1 1 27 29 40 4 20 1 50 25 5 24 48 35 17 1 35 1 28 7 7 8 30 1 1 1 1 8 28 16 22 1 1 1 20 31 1 1 46 43
1 12 16 22 1 5 1 38 25 25 23 36 1 35 48 50 30 8 23 1 34 1 1 1 12 1 12 13 23 26 38 9 1 38 28 1 1 14 14 47 23 1 32 1 31 8 15 11 47 4 1 22 17 31 1 1 19 43 1 1 1 39 40 1 25 1 7 42 1 10 1 43 1 1 49 41 32 27 40 14 37 21 16 48 43 11 1 2 26 50 19 7 42 1
15 33 17 41 32 39 25 18 27 28 21 48 43 44 25 9 41 30 1 47 1 32 35 1 25 21 1 28 21 30 1 7 32 1 36 3 3 18 4 28 23 34 23 1 26 4 35 16 28 23 8 1 33 1 36 6 6 30 23 30 28 1 33 10 26 1 48 3 1 20 30 21 17 16 28 1 1 29 1 29 16 18 10 1 8 15 1 9 1 18 6 26 20 21
37 38 5 26 1 1 35 1 21 1 12 29 31 11 34 1 10 22 1 1 36 1 1 34 45 17 17 1 30 27 1 1 27 39 46 11 21 2 26 25 16 20 50 38 50 36 19 45 1 1 17 21 1 1 1 11 50 50 11 7 42 1 4 7 17 1 1 1 1 46 33 22 19 47 3 1 46 29 10 33 38 18 39 5 1 6 2 38 2 1 1 35 2 16
33 1 29 1 17 1 1 33 49 30 45 1 38 15 38 24 1 32 16 31 1 39 19 18 47 10 12 1 33 48 31 22 3 50 20 39 25 11 14 1 33 33 1 1 31 1 37 4 1 1 4 14 1 1 6 30 2 16 39 38 35 40 10 29 46 14 50 14 7 18 47 1 3 16 24 30 8 20 24 48 5 1 8 5 11 17 23 24 11 33 6 1 18 46
1 41 5 1 1 7 46 1 1 1 21 20 1 38 24 47 1 40 30 42 31 37 32 31 8 33 49 17 31 43 19 1 38 18 5 29 44 15 1 36 1 36 8 50 34 50 20 43 23 1 23 38 23 46 1 36 11 15 11 1 36 21 48 1 44 45 8 18 29 40 1 35 1 19 10 22 35 9 29 16 34 1 38 19 1 18 49 6 1 24 1 4 42 4
15 1 1 13 2 7 9 25 18 3 20 27 9 1 1 7 1 20 30 22 1 37 19 1 27 21 13 43 15 1 32 39 3 32 41 38 7 28 28 15 26 33 18 5 45 2 8 40 19 31 40 24 31 18 1 1 1 21 31 13 24 35 1 46 24 1 39 2 50 37 36 37 15 22 35 43 27 1 29 1 10 31 34 1 39 14 18 12 24 43 7 17 1 9
50 8 41 23 31 40 7 50 1 7 36 6 32 49 24 1 5 1 1 1 16 8 25 1 1 13 1 42 1 28 1 8 1 46 1 10 23 11 21 15 1 23 4 1 1 35 22 1 35 4 50 4 45 5 36 17 38 32 23 12 1 7 1 14 1 18 31 8 22 23 30 29 18 13 3 44 10 39 48 4 47 7 12 1 17 22 38 31 25 1 1 1 1 1
33 16 1 23 39 23 1 17 39 43 6 25 5 1 20 8 25 8 28 33 41 14 35 48 38 48 14 24 38 6 4 1 43 18 1 1 23 1 1 23 35 1 1 14 1 22 16 1 8 1 32 39 1 40 1 6 20 1 1 1 8 1 17 1 41 34 42 17 10 10 9 9 13 1 3 1 1 10 28 1 1 23 1 12 1 1 11 27 43 47 50 1 14 29
47 8 25 44 13 32 26 1 1 22 10 29 41 11 1 30 41 14 1 3 8 10 48 47 28 45 15 33 1 1 15 49 45 40 46 3 6 1 37 18 25 44 4 3 1 13 31 21 31 1 29 46 3 47 1 18 47 19 1 38 11 1 33 27 7 13 27 25 1 32 1 44 24 48 21 16 14 1 1 15 20 18 14 1 39 42 42 10 1 11 43 24 23 6
