11
6 2 9 5
23 1 1 5 17 19 27 15 7 1 44
7 1 35 39 25 42 25 25 1 46 42
35 1 1 38 37 7 47 1 27 28 1
1 36 23 7 19 38 22 1 47 25 42
46 26 48 1 45 12 18 3 10 1 35
1 23 7 1 1 1 15 36 12 38 1
4 22 36 2 18 28 32 1 46 38 25
1 40 16 5 1 28 15 50 13 7 45
14 4 1 32 34 1 20 4 50 13 11
33 45 47 44 28 21 38 1 30 7 26
39 14 36 22 2 7 9 1 18 1 35
