79
25 8 31 75
5 37 1 1 7 30 50 38 1 14 23 34 35 43 6 16 32 42 33 34 1 1 30 47 32 1 1 18 1 37 37 43 27 9 1 18 1 44 17 25 1 20 1 33 45 1 22 21 43 1 1 23 33 25 43 33 5 30 3 1 23 1 39 1 1 32 39 33 21 1 28 40 36 24 13 30 24 37 24
5 21 11 14 18 1 18 23 7 29 23 24 1 35 38 6 41 12 10 1 1 43 39 1 26 40 1 15 1 28 43 34 47 29 1 11 33 2 8 1 41 37 7 42 13 10 43 1 18 29 1 50 34 10 25 50 25 39 43 4 1 44 19 14 48 36 9 14 1 48 43 1 13 12 31 1 45 14 1
42 24 3 36 49 24 40 35 1 45 18 12 29 30 17 1 14 1 31 42 16 1 31 24 17 16 43 1 14 24 1 13 24 45 34 2 11 37 8 26 2 30 4 8 8 48 2 39 1 8 4 23 1 30 48 41 27 9 48 24 1 26 1 13 14 1 25 28 9 1 10 1 1 11 36 29 47 30 8
1 36 23 1 23 34 13 5 40 17 44 1 23 1 1 1 18 39 39 16 22 8 13 19 20 27 13 14 35 29 13 10 17 15 50 1 50 36 5 21 11 31 1 11 34 45 1 14 26 1 16 50 34 37 46 25 21 38 47 14 1 7 1 1 1 1 40 32 1 2 27 19 19 44 45 1 3 37 1
42 29 28 1 3 17 49 44 34 36 36 40 44 10 1 4 7 4 25 17 30 39 1 4 30 21 1 17 21 47 14 34 48 14 1 24 41 5 32 29 8 30 1 1 15 4 33 6 20 28 42 5 6 1 6 24 31 12 31 1 34 17 44 18 32 1 4 23 42 30 30 21 1 4 25 42 1 6 1
36 50 2 35 3 20 5 11 47 12 1 9 30 22 1 9 1 33 6 49 34 16 18 19 41 19 27 1 5 33 42 4 18 1 25 14 33 1 22 44 1 20 36 9 1 40 1 36 38 15 26 6 41 1 31 20 45 19 12 28 36 15 42 6 1 15 34 48 19 16 1 1 40 1 1 1 48 6 13
1 49 30 9 20 27 25 50 7 45 50 18 11 19 1 15 23 1 3 22 8 17 45 26 13 40 10 21 22 45 27 14 1 26 15 4 1 35 1 15 1 25 1 47 40 44 6 41 1 26 30 19 14 43 9 35 8 50 22 43 50 1 24 8 26 5 1 34 5 22 1 1 50 47 42 43 47 23 3
2 46 1 36 39 23 12 37 2 44 25 41 19 35 19 30 6 1 1 44 11 26 11 1 48 2 1 31 5 1 23 8 19 50 11 10 47 1 1 1 29 1 32 11 1 12 1 8 16 27 14 1 15 1 32 1 12 1 2 37 27 2 30 1 5 19 28 1 46 7 23 43 2 14 1 14 50 1 8
1 19 1 33 1 5 1 19 1 28 1 1 42 12 42 14 33 20 27 14 15 9 21 13 35 20 49 12 1 39 44 32 40 1 22 7 13 39 1 4 22 1 7 1 11 1 2 45 34 1 41 40 1 46 14 18 24 18 25 24 25 7 12 24 38 26 1 27 23 30 6 36 1 18 20 31 50 1 1
4 27 19 1 40 14 30 29 32 28 1 19 13 1 11 12 7 1 12 49 36 1 8 1 37 4 32 1 31 1 1 35 32 20 16 39 1 45 27 14 35 38 1 41 4 42 1 9 3 25 1 9 28 22 6 14 1 23 49 1 1 34 31 20 3 40 33 20 1 48 24 5 26 24 1 1 25 5 47
1 13 1 29 21 1 25 12 27 24 1 23 43 12 18 6 30 48 1 42 22 33 1 1 5 26 1 49 1 25 6 18 3 16 18 20 21 33 26 19 16 10 1 1 10 1 40 28 32 11 7 15 1 4 1 24 2 30 10 1 43 50 43 23 41 41 34 1 3 23 1 27 45 35 48 1 1 47 1
46 4 45 1 47 7 38 35 33 23 22 1 50 1 7 7 48 1 17 34 16 12 40 25 4 39 27 21 1 20 47 26 1 3 47 22 20 1 38 6 27 1 32 1 9 39 50 2 20 1 1 1 45 5 1 7 41 5 42 1 32 23 26 1 16 1 6 38 31 1 24 19 16 20 1 28 13 23 1
9 1 6 36 27 1 10 48 24 1 1 1 24 16 1 13 1 11 36 1 25 30 30 22 28 36 34 14 15 4 33 19 10 22 1 9 14 1 16 22 40 3 19 2 1 26 42 42 44 40 13 26 26 9 9 1 17 40 33 23 43 20 44 34 1 1 50 24 31 1 2 29 5 48 5 14 23 43 27
1 10 43 21 43 38 24 27 38 24 45 26 30 2 16 29 8 24 30 1 14 1 28 21 31 41 1 36 32 10 31 1 35 42 4 1 45 5 23 1 40 15 1 15 11 19 13 1 42 22 39 20 49 29 6 1 1 38 28 44 32 47 1 3 5 34 25 1 22 38 22 29 11 1 30 41 1 36 42
43 16 16 1 1 15 23 24 40 22 4 26 21 48 43 41 18 4 36 38 48 1 23 30 46 16 45 1 29 39 1 10 30 1 1 8 19 38 50 46 45 7 3 25 15 1 42 30 18 50 1 5 3 21 23 28 49 2 23 29 38 44 1 20 45 44 47 29 9 29 49 22 41 1 1 32 15 4 30
25 37 37 11 39 1 28 35 31 21 32 40 29 1 20 38 26 37 6 36 1 1 21 24 45 50 1 37 11 1 3 20 49 1 18 31 8 15 30 34 37 1 8 20 20 29 49 19 33 26 42 22 20 1 18 1 1 3 1 9 49 28 12 1 13 1 3 50 1 40 1 17 7 16 45 38 31 20 44
23 9 41 41 48 1 1 19 44 7 14 29 19 33 1 33 7 7 7 9 1 28 1 1 1 1 48 31 47 23 1 39 9 1 21 1 41 1 30 47 1 48 1 1 47 23 30 49 32 24 11 9 22 33 15 33 16 26 40 1 46 27 27 6 40 12 33 5 35 31 30 9 33 1 29 27 33 49 33
31 27 1 1 20 49 36 1 5 47 1 3 1 41 36 9 27 31 3 22 29 1 1 43 35 13 25 1 22 49 14 37 2 1 15 1 18 34 3 1 43 42 23 18 43 16 37 31 13 33 1 4 1 46 6 32 1 19 46 44 17 4 24 25 50 24 1 41 5 1 1 23 1 47 18 1 16 1 13
42 49 27 45 1 41 36 26 28 36 29 37 16 26 42 1 30 18 31 24 33 1 25 3 32 49 1 18 1 1 9 45 10 8 42 26 1 32 18 3 19 35 13 28 21 20 41 35 7 31 1 30 10 1 1 8 25 9 1 1 1 42 11 33 10 3 23 14 39 5 1 1 27 23 1 13 43 27 30
7 37 22 24 47 26 4 36 2 32 3 47 23 35 1 14 45 27 31 1 1 14 27 1 21 23 16 12 50 28 30 10 1 1 34 4 20 29 35 22 4 4 15 50 31 4 38 39 18 25 7 44 1 38 50 14 9 12 9 37 13 36 24 34 41 2 33 44 37 36 39 6 30 5 22 44 45 1 30
34 31 4 28 1 3 33 36 39 23 45 49 48 1 33 39 35 49 9 8 46 22 48 17 17 6 21 23 50 1 40 16 31 10 1 22 1 5 8 1 31 16 28 20 38 25 1 7 16 32 5 17 27 3 32 30 47 2 50 29 14 8 46 4 47 42 2 39 49 32 33 27 42 8 30 1 46 25 40
4 24 10 6 1 39 40 24 38 26 41 45 44 4 2 1 46 1 34 1 44 39 41 5 15 37 11 42 1 14 38 20 1 24 19 27 48 50 35 9 23 44 1 1 45 16 5 1 16 4 10 34 34 5 1 36 50 16 1 3 10 32 49 1 1 18 36 10 9 1 21 1 13 26 15 28 9 50 1
17 40 1 20 50 19 16 18 1 1 1 1 9 38 1 40 41 28 1 1 9 1 16 39 46 1 43 1 1 1 1 1 17 17 22 11 18 1 12 39 24 30 33 40 26 47 10 31 1 47 6 1 8 29 1 5 13 22 5 1 2 1 8 1 46 1 33 33 4 24 3 40 36 11 49 21 8 1 8
1 45 37 40 22 30 19 19 29 39 39 25 9 1 39 13 17 25 34 7 1 9 45 30 46 27 19 48 1 1 17 7 1 49 8 43 15 39 30 50 47 1 1 1 10 25 5 18 29 45 22 20 18 33 29 49 45 37 38 50 1 37 1 29 46 1 3 17 1 16 9 1 11 23 48 1 25 10 7
36 22 33 45 27 21 19 30 21 27 49 46 2 1 30 23 15 1 1 1 1 39 18 1 41 26 19 1 16 1 28 45 40 26 1 7 28 7 1 38 2 19 1 37 13 7 40 1 1 14 1 1 20 36 45 7 1 48 7 50 11 40 1 11 23 47 1 30 1 33 45 18 11 13 34 2 5 38 39
35 6 3 1 41 44 47 40 43 5 1 18 47 49 19 42 1 17 36 14 1 19 1 28 22 19 1 28 13 34 1 26 23 34 1 22 1 9 45 1 43 1 1 7 33 45 15 1 1 16 42 47 47 33 2 8 1 2 13 15 19 45 28 10 27 20 22 1 3 1 1 10 14 1 47 27 20 1 33
42 1 1 26 1 31 1 20 1 48 1 13 24 10 46 1 9 41 40 22 49 31 8 46 46 36 40 13 39 12 41 18 45 43 21 25 39 1 7 34 38 26 44 1 19 17 41 18 40 30 23 1 36 21 48 42 1 11 34 26 36 32 1 18 12 18 24 23 19 1 43 20 30 6 25 8 46 1 2
1 8 27 14 48 27 1 1 25 43 1 9 35 1 3 1 33 8 24 1 47 5 13 1 43 19 50 35 15 1 1 30 23 1 33 1 10 8 21 18 26 1 47 1 29 45 12 1 9 47 1 1 9 32 48 1 4 39 28 49 1 49 31 29 1 6 1 5 36 5 1 42 22 6 12 1 1 11 8
42 1 38 33 19 1 1 2 2 31 1 27 18 21 36 22 27 1 18 27 13 47 1 1 24 34 1 50 1 37 48 1 12 33 8 15 49 50 25 1 45 10 24 1 1 21 7 1 21 10 46 33 6 43 16 18 7 1 14 17 43 1 36 19 13 14 11 26 46 1 36 6 31 34 45 1 49 1 47
20 1 37 1 4 32 35 26 17 17 37 33 35 24 1 1 18 1 44 49 29 48 1 38 19 6 12 35 41 30 22 38 50 1 1 34 1 42 15 38 1 1 20 10 25 5 33 37 1 24 47 1 38 34 1 6 1 37 25 35 1 49 1 14 20 43 20 4 50 5 21 14 24 11 40 1 31 20 23
11 48 43 1 42 1 36 1 12 14 15 24 1 1 28 1 41 7 37 27 1 38 1 36 30 1 9 12 29 13 21 1 49 14 16 44 27 2 1 41 1 34 9 8 35 1 26 1 16 39 1 31 1 49 33 27 12 30 27 50 1 36 26 22 39 1 43 16 22 2 31 27 1 18 7 25 30 35 31
18 32 50 33 4 27 41 1 26 41 33 26 21 1 15 1 46 1 8 24 25 45 11 1 46 34 14 41 39 11 33 1 31 46 13 16 7 1 15 1 5 1 50 13 35 10 37 1 43 43 23 4 35 32 41 11 13 15 26 24 18 36 46 8 1 1 49 25 1 32 8 24 4 20 47 2 38 30 4
1 13 1 28 21 9 29 3 7 6 1 21 4 1 29 34 50 33 6 27 1 38 1 8 41 5 1 26 11 1 42 10 4 1 4 1 29 31 37 14 33 1 1 36 1 50 13 21 1 6 48 1 47 26 8 2 13 1 26 1 39 1 33 10 48 44 29 40 25 3 41 41 38 25 18 32 48 44 13
21 9 2 4 38 1 37 35 26 1 16 44 22 9 3 31 10 1 3 43 1 3 33 5 1 3 35 4 26 1 18 12 30 29 1 44 16 45 7 14 16 1 28 1 12 16 32 30 14 46 9 4 3 1 16 38 1 33 2 9 1 21 1 14 30 44 1 1 46 1 36 45 27 1 17 46 29 2 15
47 40 7 3 1 42 1 46 43 50 12 47 11 39 32 22 1 1 1 43 5 49 40 16 36 3 1 1 18 45 19 1 12 30 2 46 1 35 44 27 31 1 44 43 30 1 35 2 1 9 1 26 4 13 1 24 14 46 26 8 1 37 28 1 39 47 1 18 19 36 22 23 39 1 8 49 15 5 1
4 44 31 1 33 44 40 7 37 1 1 20 4 33 15 16 1 43 13 1 14 33 7 19 35 1 6 45 1 47 1 26 1 38 48 7 8 47 50 9 23 1 3 4 41 29 29 15 33 12 46 31 25 24 1 1 1 28 22 37 1 15 1 30 26 22 43 3 41 45 6 41 17 2 22 37 1 48 46
22 1 31 50 35 1 27 9 1 1 10 26 32 20 21 1 10 31 1 34 1 21 50 1 50 1 1 38 47 30 21 47 1 12 42 29 44 30 31 23 6 33 38 25 3 1 1 42 1 9 1 24 41 38 35 50 8 2 8 46 50 10 35 25 1 36 18 1 20 44 45 37 24 1 44 13 50 1 20
37 48 50 47 50 42 10 17 9 10 1 1 48 1 19 36 5 25 9 3 46 16 16 42 8 2 17 37 42 1 1 44 32 8 9 15 1 1 16 42 46 50 49 42 42 1 26 16 4 46 46 1 1 18 1 38 1 22 20 27 1 7 1 22 1 28 50 33 40 5 48 18 4 46 1 14 1 37 25
48 28 28 1 1 35 30 29 19 1 29 12 35 22 1 1 33 39 37 46 3 1 14 7 9 38 4 33 1 49 29 3 35 48 13 12 43 31 22 19 19 23 39 9 19 47 7 41 46 42 42 3 46 21 33 28 34 1 1 43 6 44 8 7 2 17 5 47 36 1 23 1 1 1 49 25 44 34 18
7 38 20 1 1 5 3 4 26 25 15 1 17 24 20 2 17 3 36 32 14 9 2 36 40 26 39 15 9 1 32 48 11 1 1 43 16 18 49 1 37 25 9 12 49 39 5 1 4 50 8 23 12 3 8 39 46 1 42 33 28 29 37 38 1 1 19 12 38 21 5 5 43 1 1 36 1 8 21
8 1 1 32 19 35 47 12 40 28 49 30 23 29 35 21 23 35 32 20 1 18 18 1 36 32 1 16 30 3 6 1 1 27 22 33 26 18 32 29 39 43 1 1 38 39 37 24 43 24 49 43 37 1 9 40 27 20 31 7 24 43 26 15 30 34 11 19 38 9 34 7 15 38 7 30 31 8 1
26 1 13 3 22 35 21 5 9 15 1 41 38 19 50 46 1 1 30 48 22 12 43 23 9 1 14 1 1 47 27 1 1 26 11 23 1 7 26 5 1 15 4 1 19 10 35 11 21 24 15 26 37 12 1 1 24 1 7 47 49 16 6 20 22 1 29 1 1 19 40 1 19 40 46 38 3 39 18
49 37 16 27 12 29 1 11 1 26 26 49 32 18 48 9 42 1 30 33 9 1 1 44 24 21 4 37 19 35 23 19 27 27 45 49 49 13 24 1 42 25 11 1 10 7 13 10 1 48 36 49 1 27 29 9 41 7 6 40 1 8 35 1 1 29 35 18 26 30 18 1 28 1 30 1 1 36 44
35 27 41 4 30 6 1 36 11 13 34 17 49 12 23 50 39 42 1 13 21 16 40 44 29 27 39 32 32 2 12 47 9 1 14 19 31 9 12 1 4 13 1 1 45 40 3 11 41 44 11 21 48 39 21 49 50 19 50 11 9 39 1 39 1 1 43 1 48 1 48 44 9 38 21 24 9 6 1
1 1 31 50 29 43 40 6 38 30 8 9 43 1 16 27 13 24 49 16 1 27 48 1 2 47 16 23 31 34 13 21 20 41 1 44 10 1 31 1 5 30 1 48 43 31 9 18 6 42 29 42 33 1 1 43 1 18 1 8 1 24 38 13 1 14 9 47 1 44 19 44 45 1 48 1 33 18 1
20 49 14 10 31 1 20 1 1 28 9 50 31 11 49 25 4 14 7 31 30 16 13 35 4 14 44 10 27 29 5 14 40 11 1 40 31 31 10 1 1 6 8 42 34 45 28 36 9 16 48 1 36 8 48 4 1 24 26 35 48 9 37 31 1 4 1 16 41 21 14 21 21 42 2 6 31 1 1
1 10 1 10 42 24 1 38 30 3 1 12 46 28 36 6 33 15 1 1 1 21 24 13 48 46 40 4 1 21 5 30 1 27 47 9 43 1 1 4 1 30 40 4 42 34 46 21 47 1 47 1 22 17 9 22 23 1 2 15 1 38 6 1 1 1 13 24 1 15 5 49 35 42 50 16 1 48 14
12 49 45 44 22 1 20 1 25 43 33 15 43 16 1 13 6 27 1 32 22 33 2 33 38 39 39 16 1 23 1 1 24 42 36 27 35 50 38 31 31 48 27 3 32 45 13 8 5 12 8 1 31 14 16 36 3 1 7 15 16 29 1 43 7 45 34 31 35 1 12 45 45 1 1 8 11 41 42
2 23 26 1 47 5 17 5 48 15 24 1 1 5 1 46 31 27 30 18 27 47 34 41 1 36 2 41 22 28 1 21 22 6 27 15 7 10 32 1 26 38 29 10 34 6 32 42 25 47 1 1 28 19 1 31 4 24 1 30 12 46 27 1 36 1 47 9 1 46 27 20 48 33 24 35 47 33 6
1 18 27 1 24 20 3 50 47 42 1 17 27 27 1 21 48 9 31 1 32 1 36 49 1 1 30 12 19 33 30 38 25 27 38 1 1 1 1 3 1 12 1 40 16 12 44 10 1 21 10 1 1 42 37 27 23 1 38 43 16 41 1 1 50 32 13 1 20 39 40 40 9 28 22 41 7 26 47
7 1 1 1 1 42 31 21 25 10 22 38 46 1 4 46 1 17 4 25 25 2 5 15 44 1 7 40 31 1 46 47 45 12 6 1 40 42 1 41 47 50 47 16 30 1 19 9 21 10 5 34 30 37 3 40 1 10 1 10 2 1 31 1 1 41 1 32 1 27 1 1 11 7 44 33 1 32 4
46 3 35 6 4 1 9 15 35 41 1 18 1 7 36 28 6 13 27 1 48 1 10 24 1 20 1 38 3 19 31 30 17 29 1 1 25 18 41 12 7 1 39 44 1 1 32 17 31 36 26 1 48 40 28 31 1 1 46 5 19 15 30 28 14 12 3 49 1 45 8 34 30 17 22 6 1 1 4
1 50 28 10 21 3 1 16 32 1 33 39 41 1 11 1 1 1 22 29 1 48 46 12 18 11 1 1 25 20 2 6 1 1 43 25 26 38 29 39 1 11 1 20 1 22 12 9 10 37 1 1 28 40 1 6 3 25 27 22 37 43 8 35 16 31 1 21 1 1 40 27 44 1 17 40 37 20 4
29 1 1 1 19 1 1 20 10 45 28 11 1 1 27 5 38 21 20 17 12 1 1 14 1 1 23 48 1 38 20 33 3 47 13 28 42 46 14 1 30 26 17 46 28 9 10 1 27 1 34 1 1 5 4 40 45 22 23 44 31 11 1 18 31 50 1 11 37 49 39 1 49 48 2 29 19 1 5
44 23 1 36 21 1 12 28 30 35 1 1 1 1 40 1 50 29 31 43 5 36 1 1 22 31 1 37 18 11 1 19 6 11 1 28 14 25 38 1 1 26 1 49 43 44 45 38 31 41 41 31 41 6 4 27 44 1 1 31 47 36 1 41 45 13 31 26 1 31 1 28 1 34 4 23 30 35 40
4 1 9 11 37 1 26 1 9 24 9 48 1 1 1 9 17 24 40 49 1 1 17 48 24 37 19 1 23 34 22 25 29 39 1 14 11 10 21 43 16 5 38 34 34 32 42 13 42 44 36 50 3 1 34 2 1 18 20 1 45 39 50 1 1 3 46 10 1 1 1 10 1 21 49 1 37 48 18
49 1 17 38 27 20 15 6 22 22 40 1 40 32 34 1 9 1 10 9 1 34 42 34 50 49 3 18 12 32 40 1 42 18 1 17 7 26 50 33 41 37 22 6 13 41 7 24 10 27 9 48 21 30 1 3 38 35 17 6 46 10 22 34 1 14 44 12 31 16 29 16 26 39 50 11 8 10 11
42 48 44 41 1 3 47 17 7 21 19 37 36 1 27 30 1 1 40 48 35 23 23 24 39 1 40 34 1 39 1 18 42 12 1 1 27 36 11 33 40 14 1 47 17 34 47 1 1 22 30 1 32 2 45 1 1 17 2 40 44 1 23 35 26 1 1 1 1 11 21 1 1 23 22 42 23 19 1
41 34 38 30 27 1 25 15 1 43 1 36 1 39 38 1 17 42 42 46 49 26 22 1 1 49 27 21 28 49 31 42 28 6 1 22 23 2 42 47 30 1 31 1 34 22 11 23 1 42 1 43 36 13 30 4 13 1 28 30 48 7 38 6 18 19 9 1 46 14 1 5 23 24 49 1 13 31 9
35 34 1 30 24 40 50 1 44 45 43 2 27 6 19 39 37 44 36 42 4 1 27 6 32 1 14 33 37 25 1 33 5 41 1 31 48 31 1 35 1 40 32 1 24 1 35 21 1 1 4 23 10 1 12 1 50 1 36 25 47 13 43 20 14 23 46 36 40 27 1 22 14 49 45 21 33 1 11
6 28 33 16 1 38 1 22 24 36 15 50 42 35 30 5 22 20 30 1 1 49 1 1 43 15 48 6 9 1 24 31 4 36 49 40 45 19 1 8 1 48 7 1 48 47 1 13 1 46 25 12 18 1 16 1 40 13 1 24 28 45 21 27 1 23 14 35 25 34 25 33 1 45 32 1 1 19 1
36 4 15 41 1 8 29 37 16 1 34 23 6 7 37 43 19 6 29 5 25 41 36 44 23 29 49 8 5 1 31 40 31 16 16 8 1 1 1 6 12 1 38 1 1 3 23 45 4 8 20 26 47 43 47 28 4 43 1 21 1 41 1 17 48 30 18 12 1 1 2 37 37 34 2 42 14 1 8
29 1 23 1 1 36 32 1 1 29 30 1 26 19 46 2 1 7 36 8 1 1 37 1 26 1 18 46 6 25 33 46 44 1 20 1 10 29 20 38 23 50 1 18 1 4 1 36 23 1 1 1 1 1 39 1 25 4 1 46 1 44 47 21 10 18 10 1 1 26 44 34 46 46 14 48 6 1 1
41 8 2 1 12 49 40 36 32 1 21 1 40 1 41 12 5 3 26 29 24 24 30 36 49 29 46 6 21 7 8 47 5 28 20 1 1 1 5 32 12 28 16 1 46 11 39 50 17 1 1 2 1 31 8 27 2 26 21 18 7 2 12 30 18 16 9 1 41 1 1 13 9 44 46 28 44 14 24
21 1 7 39 30 22 44 1 24 31 36 34 23 1 11 15 41 1 1 22 10 1 9 46 28 1 50 21 36 14 1 8 27 10 31 1 47 5 29 29 43 7 1 28 1 25 1 21 1 27 26 23 49 39 1 11 1 1 13 21 29 18 1 1 1 42 1 39 8 27 28 47 43 45 1 1 7 9 17
32 1 11 44 36 29 47 40 35 1 27 48 41 21 15 3 32 26 17 37 20 15 37 49 1 12 38 1 5 30 7 48 11 37 23 8 1 45 33 4 4 45 33 10 49 9 28 44 21 23 1 8 20 31 24 48 4 46 35 30 1 33 1 28 33 32 40 1 38 1 1 47 49 26 21 15 10 41 1
24 14 1 34 1 20 7 41 1 28 1 1 12 1 6 4 49 16 1 19 23 11 33 1 30 1 1 39 1 1 41 8 22 14 32 1 1 33 45 1 27 50 2 10 1 19 16 26 1 1 18 1 4 7 22 47 11 37 32 39 46 24 1 15 47 28 9 29 28 1 1 48 46 11 1 1 17 1 29
11 31 31 1 48 10 35 1 38 1 27 1 2 42 23 33 19 35 1 1 29 19 1 42 35 28 35 11 32 30 3 9 15 32 1 1 33 16 19 23 45 22 1 16 45 41 9 35 23 22 2 30 14 39 6 9 10 45 37 1 1 25 1 3 40 1 47 19 1 5 24 20 31 1 1 9 23 19 37
33 1 22 1 1 1 15 1 15 1 2 1 10 1 16 43 42 2 12 9 40 50 1 24 12 27 1 10 1 33 38 5 1 16 31 44 12 40 7 9 29 11 20 1 1 26 1 37 23 10 1 1 1 18 40 27 31 31 12 1 20 1 1 38 1 35 5 28 10 43 6 45 38 17 1 14 22 41 27
7 43 19 37 42 18 40 7 10 1 1 13 1 13 1 2 33 1 1 46 2 48 10 1 1 1 26 49 1 28 4 40 1 1 1 1 31 2 32 1 46 1 49 35 25 1 36 6 31 5 1 1 15 13 29 16 27 49 1 38 44 41 1 9 30 9 44 49 48 19 25 44 45 1 1 32 21 18 50
36 16 35 19 1 8 39 6 34 1 10 1 1 40 1 1 47 43 47 24 37 26 2 1 42 29 47 1 3 17 12 49 1 1 36 4 37 1 7 1 16 1 21 18 39 41 48 49 1 10 46 6 1 6 1 43 33 1 13 21 6 48 11 4 46 4 16 1 1 1 36 24 33 4 25 49 1 1 14
3 20 45 43 6 44 18 1 1 1 26 25 29 39 1 5 47 40 47 13 45 41 16 43 4 31 7 27 8 38 28 45 1 29 12 47 1 46 5 40 7 30 2 1 20 32 47 33 22 1 36 1 30 16 5 11 36 23 49 1 9 24 11 1 9 1 1 31 1 19 1 45 18 9 22 50 36 47 3
1 1 43 1 19 7 8 13 49 5 1 8 1 14 10 9 31 14 42 6 1 18 29 44 20 2 22 5 1 1 18 36 15 39 1 39 1 1 43 36 47 45 29 1 1 28 1 6 42 25 48 1 13 1 3 1 47 49 14 13 1 7 48 1 47 49 1 2 28 28 2 47 18 1 1 29 37 21 48
1 11 1 47 27 35 17 50 12 16 29 1 46 10 45 19 35 44 1 33 45 1 24 44 1 31 44 4 1 41 3 19 5 1 15 35 4 29 17 1 1 5 25 43 14 1 4 8 43 10 16 33 44 39 14 31 4 35 40 35 50 9 1 1 9 38 32 43 10 1 1 1 7 30 49 27 41 1 48
20 9 41 34 25 30 42 49 12 48 19 28 2 43 46 37 13 39 9 30 36 1 1 25 18 26 22 44 14 20 1 31 24 10 47 37 1 24 18 26 38 50 8 33 17 43 1 38 1 48 24 30 8 23 9 7 33 46 1 18 1 3 9 5 1 37 1 27 1 25 1 1 1 17 1 16 1 11 1
32 25 9 15 12 14 4 1 17 50 14 23 26 13 47 4 4 25 47 11 29 24 1 1 20 1 22 14 25 47 14 17 1 25 1 23 2 23 40 34 16 8 25 37 35 40 21 1 14 42 31 32 30 36 10 47 1 2 1 1 41 1 43 18 35 1 31 4 1 10 1 35 34 1 32 10 19 34 1
5 43 46 30 1 2 1 33 1 1 34 1 26 32 24 19 9 40 1 1 1 41 16 1 45 1 47 17 12 1 1 46 9 38 48 42 26 1 16 1 39 6 22 41 18 1 26 28 43 15 6 13 1 38 50 43 1 14 26 38 26 8 26 1 24 29 38 11 26 30 43 5 30 42 5 1 21 46 22
19 43 1 14 1 7 26 35 13 16 46 1 42 1 27 16 1 42 1 39 1 3 1 1 47 20 1 22 3 26 24 15 10 45 1 22 1 44 30 1 37 1 21 21 2 1 19 2 1 8 21 4 21 25 16 17 30 1 18 47 18 29 8 35 23 1 37 36 26 1 9 22 27 11 48 33 30 30 1
1 42 15 47 8 10 50 4 1 3 23 38 16 38 1 25 31 4 16 1 15 6 39 1 1 1 1 4 10 45 32 4 38 1 31 27 1 24 3 10 25 34 1 1 30 28 32 28 1 13 37 1 48 4 40 21 46 1 38 20 41 12 18 1 39 22 41 17 33 25 1 1 12 19 29 18 37 41 23
