29
14 14 18 27
17 1 15 6 19 13 1 1 29 10 1 50 49 24 26 1 31 33 10 1 1 5 1 34 36 44 46 25 1
25 16 1 47 41 5 1 37 19 23 45 37 1 21 41 14 49 29 1 6 46 16 38 20 1 18 3 1 24
20 5 38 36 34 42 8 19 10 16 44 13 20 45 35 37 1 1 35 15 22 28 23 30 1 35 29 19 49
37 1 1 1 43 19 2 43 28 8 1 29 1 1 43 49 41 47 27 12 40 42 1 39 8 1 20 12 3
24 1 21 1 37 7 1 6 32 11 37 35 42 12 28 31 26 35 1 21 19 1 15 6 50 29 13 46 17
50 1 17 37 1 45 1 3 45 16 32 30 31 1 8 39 1 38 24 1 3 10 32 8 1 1 21 46 1
7 39 33 35 29 27 1 16 34 46 37 39 12 38 47 37 47 46 26 10 38 13 30 9 21 48 29 17 12
39 47 1 39 28 30 1 1 12 16 15 38 1 18 1 15 19 17 1 8 31 1 8 32 44 26 8 7 21
28 47 1 1 1 1 4 7 1 48 2 4 1 31 21 1 1 3 35 1 49 42 36 39 13 1 1 15 46
17 21 33 17 23 39 33 16 1 11 1 1 1 26 23 14 40 1 15 50 1 36 1 46 3 33 39 45 1
22 1 12 19 48 1 6 1 38 39 31 1 38 18 1 34 39 23 5 48 32 1 14 13 1 9 44 11 26
1 41 24 22 7 21 46 10 23 38 1 49 29 5 29 16 2 37 24 37 45 43 46 40 34 29 18 1 7
14 1 12 2 30 22 16 42 1 5 44 1 21 10 13 1 13 45 6 5 29 21 14 24 28 2 33 22 1
1 1 23 31 8 43 27 16 1 11 9 2 24 1 1 32 44 1 1 4 41 47 3 21 1 5 1 42 23
25 8 1 20 9 10 25 1 1 1 38 25 49 1 44 11 46 28 1 1 1 39 13 1 13 14 20 10 1
50 50 1 11 1 27 1 28 6 18 19 34 22 4 15 30 30 5 43 29 47 31 16 34 17 1 17 1 42
1 13 28 2 36 12 17 16 45 1 3 24 21 2 10 1 13 42 31 6 1 35 1 10 44 43 37 22 30
1 34 39 2 25 1 1 26 23 10 1 5 25 1 34 1 1 26 13 37 2 1 11 29 28 41 1 43 36
21 24 48 33 1 49 10 33 1 38 34 47 31 1 21 6 10 3 1 41 43 16 6 1 23 24 26 6 6
1 1 24 1 2 29 36 31 46 42 31 1 1 33 12 32 3 35 9 29 19 1 21 1 18 28 28 27 42
1 2 1 30 30 28 2 14 1 1 1 1 38 44 27 1 5 14 17 13 21 9 19 9 16 15 23 30 31
48 1 31 1 9 4 9 50 32 1 31 41 1 38 45 31 22 33 9 1 44 33 16 44 32 44 15 1 1
1 12 37 23 24 34 4 16 39 40 7 27 4 26 26 45 1 4 4 48 19 33 25 36 1 19 1 39 34
7 1 1 1 37 35 1 9 30 19 3 5 49 20 20 6 20 35 1 1 29 22 35 22 25 12 37 12 1
21 1 5 9 8 1 9 46 6 1 45 38 31 1 44 1 12 6 1 17 31 8 2 29 1 18 12 8 30
1 46 1 1 31 44 24 24 5 33 1 11 46 32 1 26 42 10 4 48 4 36 1 47 28 35 33 9 44
1 46 1 37 1 31 1 6 11 17 1 29 20 17 49 5 40 45 2 1 10 21 37 16 17 28 38 15 1
26 3 1 26 50 31 28 15 29 1 17 14 43 5 1 2 26 1 19 41 12 48 18 50 31 29 39 47 46
8 18 9 1 1 33 4 14 10 20 8 44 33 4 49 45 2 49 22 28 1 38 4 4 1 1 1 38 37
